# IGO and NGO actor list for TABARI coding
# 
# This work was funded by US National Science Foundation grant SES-0719634
#
# This work is licensed under a Creative Commons
# Attribution-NonCommercial 3.0 Unported License.
#
# This dictionary is provided by the Computational Event Data System Project:
# http://eventdata.parusanalytics.com
#
# Last update [documentation only]: 2 October 2013

A.G._KISHORE_	[NGOHINRAD]; World Hindu Council; NGO_Actors
A._G._KISHORE_	[NGOHINRAD]; World Hindu Council; NGO_Actors
ABC_RADIO_	[USAMED] ;MleH 06 Aug 2009; AllOtherCountries.txt
ABRAHAM_ABRAHAM_	[IGOUNOREFHCR] ;MleH 23 Jul 2009; NGO_Actors
ACADEMY_FOR_EDUCATIONAL_DEVELOPMENT_	[NGOEDU]; NGO_Actors
ACHARYA_G KISHORE_	[NGOHINRAD]; World Hindu Council; NGO_Actors
ACHARYA_KISHORE_	[NGOHINRAD]; World Hindu Council; NGO_Actors
ACTIONAID_	[NGODEV] ;MleH 11 Aug 2009; NGO_Actors
ACTION_AGAINST_HUNGER_	[NGOHLH]; NGO_Actors
ACTION_CANADA_FOR_POPULATION_AND_DEVELOPMENT_	[NGOCANHLH]; NGO_Actors
ACTION_FOR_AGRICULTURAL_RENEWAL_IN_MAHARASHTRA_	[NGOINDAGR]; NGO_Actors
ACTION_FOR_SOUTHERN_AFRICA_	[NGOSAFDEV]; NGO_Actors
ACTION_WITHOUT_BORDERS_	[NGOUSA]; NGO_Actors
ADDAMEER_	[NGOPALHRI]; NGO_Actors
ADVENTIST_DEVELOPMENT_&_RELIEF_AGENCY_INTERNATIONAL_	[NGOCHRPRODEV]; NGO_Actors
ADVENTIST_DEVELOPMENT_AND_RELIEF_AGENCY_INTERNATIONAL_	[NGOCHRPRODEV]; NGO_Actors
ADVISORY_COMMITTEE_ON_PROTECTION_OF_THE_SEA_	[NGOGBRENV]; NGO_Actors
AED_SATELLIFE_CENTER_FOR_HEALTH_INFORMATION_AND_TECHNOLOGY_	[NGOHLH]; NGO_Actors
AFICAN_UNION_	[IGOAFRAFU] ;MleH 13 Aug 2009; NGO_Actors
AFP_	[FRAMED] ;MleH 17 Jul 2009; AllOtherCountries.txt
AFRICA_	[AFR] ;MleH 20 Jul 2009; AllOtherCountries.txt
AFRICA'S_LARGEST_COUNTRY_	[SDN]; AllOtherCountries.txt
AFRICAN_ACADEMY_OF_SCIENCES_	[NGOAFREDU]; NGO_Actors
AFRICAN_COMMUNITY_REFUGEE_CENTER_	[NGOUSAREF]; NGO_Actors
AFRICAN_DEVELOPMENT_INSTITUTE_INC_	[NGOAFRDEV]; NGO_Actors
AFRICAN_ECONOMIC_RESEARCH_CONSORTIUM_	[NGOAFRDEV]; NGO_Actors
AFRICAN_GENDER_INSTITUTE_	[NGOAFRHRI]; NGO_Actors
AFRICAN_UNION_	[IGOAFRAFU] ;MleH 13 Aug 2009; NGO_Actors
AFRICARE_	[NGOAFRDEV]; NGO_Actors
AFRICA_ACTION_	[NGOAFRDEV]; NGO_Actors
AFRICA_PROGRESS_PANEL_	[NGOAFRDEV] ;MleH 11 Aug 2009; NGO_Actors
AGENCE_FRANCE_PRESS_	[FRAMED]; AllOtherCountries.txt
AGRICULTURE_NETWORK_INFORMATION_CENTER_	[USAEDUAGR]; AllOtherCountries.txt
AGUA_BOLIVIA_	[NGOBOLENV]; NGO_Actors
AG_KISHORE_	[NGOHINRAD]; World Hindu Council; NGO_Actors
AHMAD_IBRAHIM_AL_TAHIR_	[SDNLEG] ;MleH 13 Aug 2009; AllOtherCountries.txt
AID_GROUP_	[NGO] ;MleH 09 Jul 2009; NGO_Actors
AKINA_MAMA_WA_AFRIKA_	[NGOAFR]; NGO_Actors
ALAN_GUTTMACHER_INSTITUTE_	[NGOHLH]; NGO_Actors
ALBERICO_CASARDI_	[IGOWSTNAT 580101-621231]; IGOrulers.txt
ALDEN_CLAUSEN_	[IGOUNODEVWBK 810701-860630]; IGOrulers.txt
ALDEN_W._CLAUSEN_	[IGOUNODEVWBK 810701-860630]; IGOrulers.txt
ALDEN_W_CLAUSEN_	[IGOUNODEVWBK 810701-860630]; IGOrulers.txt
ALDO_MORO_	[IGOEUREEC 710701-711231] ; president of the CoEU from ITALY; IGOrulers.txt
ALESSANDRO_MINUTO_RIZZO_	[IGOWSTNAT 010101-071231]; IGOrulers.txt
ALIRAN_	[NGMMALHRI]; NGO_Actors
ALI_BIN_IBRAHIM_AL_NU'AYMI_  [SAUGOVBUS] ;MleH 09 Jul 2009; AllOtherCountries.txt
AYAAN_HIRSI_ALI_	[NLDELIATH]
GEORGE_SOROS_	[USAELIBUS]
MERCER_REYNOLDS_	[USAELIBUS]
RUSH_LIMBAUGH_	[USAMEDELI]; conservative talk radio host
SCOTT_JENKINS_	[USAELIBUS]
TED_TURNER_	[USAMEDELI]
ALL_INDIA_D_KOTNIS_MEMORIAL_COMMITTEE_	[NGOINDHLH]; NGO_Actors
ALL_INDIA_WOMEN'S_EDUCATION_FUND_ASSOCIATION_	[NGOIND]; NGO_Actors
ALOHA_MEDICAL_MISSION_	[NGOUSAHLH] ;MleH 06 Aug 2009; NGO_Actors
ALTERNATIVE_INFORMATION_AND_DEVELOPMENT_CENTRE_	[NGOSAFHRI]; NGO_Actors
ALUKA_	[NGOUSAEDU]; NGO_Actors
AL_HAQ_	[NGOPALHRI]; NGO_Actors
AL_JAZEERA_	[QATMED] ;MleH 15 Jul 2009; AllOtherCountries.txt
AL_MEZAN_	[NGOPALHRI]; NGO_Actors
AMAZON_INDIAN_	[BRA] ;MleH 11 Aug 2009; AllOtherCountries.txt
AMAZON_WATCH_	[NGOSAMENV]; NGO_Actors
AMEDEO_DE_FRANCHIS_	[IGOWSTNAT 890101-941231]; IGOrulers.txt
AMERICAN_ARAB_	[USAARB]; AllOtherCountries.txt
AMERICAN_ASSOCIATION_OF_FAMILY_AND_CONSUMER_SCIENCES_	[NGOUSAEDU]; NGO_Actors
AMERICAN_ASSOCIATION_OF_JURISTS_	[NGO]; covers all the Americas, all about sovereignty, self-determination, etc.; NGO_Actors
AMERICAN_ASSOCIATION_OF_UNIVERSITY_WOMEN_	[USAEDU]; AllOtherCountries.txt
AMERICAN_CIVIL_LIBERTIES_UNION_	[USAHRI]; AllOtherCountries.txt
AMERICAN_EDUCATIONAL_RESEARCH_ASSOCIATION_	[NGOUSAEDU]; NGO_Actors
AMERICAN_ENTERPRISE_INSTITUTE_	[USACVL]; do advocacy-prone think tanks qualify as EDU?; AllOtherCountries.txt
AMERICAN_FRIENDS_SERVICE_COMMITTEE_	[NGOCHRHRI]; NGO_Actors
AMERICAN_GEOPHYSICAL_UNION_	[NGOEDU]; NGO_Actors
AMERICAN_HUMANIST_ASSOCIATION_	[USAATH]; AllOtherCountries.txt
AMERICAN_INTERNATIONAL_HEALTH_ALLIANCE_	[NGOUSAHLH]; NGO_Actors
AMERICAN_MATHEMATICAL_SOCIETY_	[USAEDU]; AllOtherCountries.txt
AMERICAN_MEDICAL_WOMEN'S_ASSOCIATION_	[NGOUSAHLH]; NGO_Actors
AMERICAN_NEAR_EAST_REFUGEE_AID_	[NGOPALREF]; NGO_Actors
AMERICAN_PHYSICAL_SOCIETY_	[NGOUSAEDU]; NGO_Actors
AMERICAN_POLITICAL_SCIENCE_ASSOCIATION_	[USAEDU]; AllOtherCountries.txt
AMERICAN_PSYCHOLOGICAL_ASSOCIATION_	[USAEDU]; AllOtherCountries.txt
AMERICAN_REFUGEE_COMMITTEE_	[NGOUSAREF]; its INTERNATIONAL version is similarly USA-centric; NGO_Actors
AMERICAN_TASK_FORCE_ON_PALESTINE_	[NGOPAL]; NGO_Actors
AMERICAN_TROOPS_	[USAMIL] ;ELH 06 Jul 2009; AllOtherCountries.txt
AMERICA_NEPAL_MEDICAL_FOUNDATION_	[NGONPLHLH]; NGO_Actors
AMIGOS_DE_LA_TIERRA_	[NGOESPENV]; NGO_Actors
AMINTORE_FANFANI_	[IGOEUREEC 650701-651231] ; president of the CoEU from ITALY; IGOrulers.txt
AMNESTY_INTERNATIONAL_	[NGOHRIAMN]; NGO_Actors
ANERA_	[NGOPALREF]; NGO_Actors
ANTHONY_CROSLAND, THEN DAVID OWEN_	[IGOEUREEC 770101-770630] ; president of the CoEU from UNITED_KINGDOM; IGOrulers.txt
ANTI_RACISM_INFORMATION_SERVICES_	[NGOHRI]; NGO_Actors
ANTI_SLAVERY_INTERNATIONAL_	[NGOGBRHRI]; NGO_Actors
APINAJE_INDIAN_	[BRA] ;MleH 11 Aug 2009; AllOtherCountries.txt
ARABIAN_SEA_	[MEA] ;MleH 14 Jul 2009; AllOtherCountries.txt
ARAB_ASSOCIATION_FOR_HUMAN_RIGHTS_	[NGOPALHRI]; NGO_Actors
ARAB_COOPERATION_COUNCIL_	[IGOMEAACC]; NGO_Actors
ARAB_ECONOMIC_UNITY_COUNCIL_	[IGOMEAAEU]; NGO_Actors
ARAB_LEAGUE_	[IGOMEAARL]; NGO_Actors
ARAB_MAGHREB_UNION_	[IGOMEAAMU]; is North Africa really the Middle East?; NGO_Actors
ARAB_MONETARY_FUND_FOR_ECONOMIC_AND_SOCIAL_DEVELOPMENT_	[IGOMEAAMF]; NGO_Actors
ARAB_ORGANIZATION_FOR_HUMAN_RIGHTS_	[NGOARBHRI]; NGO_Actors
ARAB_PROGRAM_FOR_HUMAN_RIGHTS_ACTIVISTS_	[NGOARBHRI]; NGO_Actors
ARAB_WOMEN'S_SOLIDARITY_ASSOCIATION_	[NGOARBHRI]; NGO_Actors
ARCHAEOLOGISTS_FOR_HUMAN_RIGHTS_	[NGODEUHRI]; NGO_Actors
ARMENIAN_INTERNATIONAL_WOMEN'S_ASSOCIATION_	[NGOARM]; NGO_Actors
ART_IN_DEFENSE_OF_HUMANISM_	[NGODNK]; need more detail on this association, but none is forthcoming; NGO_Actors
ART_OF_LIVING_FOUNDATION_	[NGOINDTAMRELHLH]; spiritual healing and stress relief; NGO_Actors
ASDHVI_RITAMBHARA_	[NGOHINRAD]; World Hindu Council; NGO_Actors
ASEAN_	[IGOSEAASN]; Assoc South East Asian Nations (security); NGO_Actors
ASEAN_COUNTRIES_	[IGOSEAASN] ;MleH 08 Jul 2009; NGO_Actors
ASEAN_DEFENSE_MINISTERS_	[IGOAEAASN] ;ELH 07 Jul 2009; NGO_Actors
ASHOK_SINGHAL_	[NGOHINRAD]; World Hindu Council; NGO_Actors
ASIAN_FEDERATION_AGAINST_INVOLUNTARY_DISAPPEARANCES_	[NGOASAHRI]; NGO_Actors
ASIAN_HUMAN_RIGHTS_COMMISSION_	[NGOASAHRI]; NGO_Actors
ASIAN_LEGAL_RESOURCE_CENTRE_	[NGOASAHRI]; NGO_Actors
ASIA_PACIFIC_PARTNERSHIP_ON_CLEAN_DEVELOPMENT_	[IGOENV] ;MleH 10 Aug 2009; NGO_Actors
ASOCIACION_ANAI_	[NGOCRIENV]; NGO_Actors
ASOCIACION_GUATEMALTECA_PARA_LA_CONSERVACION_NATURAL_	[NGOGTMENV]; NGO_Actors
ASOCIACION_SAN_LUCAS_	[PERCHRHLH]; AllOtherCountries.txt
ASSOCIATED_COUNTRY_WOMEN_OF_THE_WORLD_	[NGODEV]; NGO_Actors
ASSOCIATED_PRESS_	[USAMED] ;MleH 06 Aug 2009; AllOtherCountries.txt
ASSOCIATES_FOR_GLOBAL_CHANGE_	[NGOAFRDEV]; NGO_Actors
ASSOCIATION_FOR_PROGRESSIVE_COMMUNICATIONS_	[NGOMED]; Provision of Internet, especially in Africa; NGO_Actors
ASSOCIATION_FOR_STIMULATING_KNOW_HOW_	[NGOINDDEV]; NGO_Actors
ASSOCIATION_FOR_SUPERVISION_AND_CURRICULUM_DEVELOPMENT_	[NGOUSAEDU]; NGO_Actors
ASSOCIATION_FOR_THE_DEFENSE_OF_THE_NATURE_AND_RESOURCES_OF_EXTREMADURA_	[ESPENV]; AllOtherCountries.txt
ASSOCIATION_FOR_THE_PREVENTION_OF_TORTURE_	[NGOHRI]; NGO_Actors
ASSOCIATION_FOR_THE_PROTECTION_OF_THE_ENVIRONMENT_	[NGOEGYDEV]; NGO_Actors
ASSOCIATION_FOR_WOMEN_IN_DEVELOPMENT_	[NGODEV]; NGO_Actors
ASSOCIATION_FOR_WOMEN_IN_SCIENCE_	[USAEDU]; AllOtherCountries.txt
ASSOCIATION_FOR_WORLD_EDUCATION_	[NGOEDU]; NGO_Actors
ASSOCIATION_OF_COFFEE_PRODUCING_COUNTRIES_	[IGOAGRCPC]; potentially BUS instead; NGO_Actors
ASSOCIATION_OF_JUNIOR_LEAGUES_INTERNATIONAL,_INC_	[NGODEV]; NGO_Actors
ASSOCIATION_OF_SOCIAL_ENGINEERING,_RESEARCH_AND_TRAINING_	[NGOINDDEV]; NGO_Actors
ASSOCIATION_OF_SOUTHEAST_ASIAN_NATIONS_	[IGOSEAASN]; NGO_Actors
ASSOCIATION_OF_SOUTHEAST_ASIA_NATIONS_	[IGOSEAASN] ;CTA 14 Jul 2009; NGO_Actors
ASSOCIATION_OF_SOUTH_EAST_ASIAN_NATIONS_	[IGOSEAASN] ;MleH 07 Jul 2009; NGO_Actors
ASSOCIATION_OF_WORLD_CITIZENS_	[NGO]; world peace; NGO_Actors
ATAUS_SAMAD_	[GBRMEDBGD]; AllOtherCountries.txt
ATCNET_	[NGOAFRBUSDEV]; NGO_Actors
ATHLETES_UNITED_FOR_PEACE_	[NGOUSA]; generally for peace; NGO_Actors
ATTILIO_RUFFINI_	[IGOEUREEC 800101-800630] ; president of the CoEU from ITALY; IGOrulers.txt
AUPSC_	[IGOAFRAFU] ;MleH 13 Aug 2009; NGO_Actors
AUSTRALIAN_COALITION_FOR_DEMOCRACY_IN_BURMA_	[NGOMMRHRI] ;MleH 06 Aug 2009; NGO_Actors
AUSTRIAN_AIRLINES_  [AUTBUS] ;MleH 06 Jul 2009; AllOtherCountries.txt
AVOCATS_SANS_FRONTIERES_	[NGOHRI]; NGO_Actors
AYMAN_NOUR_	[EGYOPP >050101] [EGYOPPPTY] [---] ;MleH 05 Aug 2009; AllOtherCountries.txt
A_G_KISHORE_	[NGOHINRAD]; World Hindu Council; NGO_Actors
A_ROCHA_INTERNATIONAL_	[NGOCHRENV]; NGO_Actors
BALKAR_SINGH_	[CANSIK]; AllOtherCountries.txt
BANGLADESH_HUMAN_RIGHTS_NETWORK_	[NGOBGDHRI]; NGO_Actors
BANK_FOR_INTERNATIONAL_SETTLEMENTS_	[IGOBUSBIS]; NGO_Actors
BANK_INFORMATION_CENTER_	[NGOBUS]; NGO_Actors
BARBER_CONABLE_	[IGOUNODEVWBK 860701-910831]; IGOrulers.txt
BARON_ADOLPH_BENTINCK_	[IGOWSTNAT 560101-581231]; IGOrulers.txt
BBC_	[GBRMED] ;MleH 04 Aug 2009; AllOtherCountries.txt
BENEDICT_XVI_	[CHRCTH] ;MleH 10 Jul 2009; ReligiousGroups.txt
BERND_PFAFFENBACH_  [DEUGOVBUS] ;MleH 09 Jul 2009; AllOtherCountries.txt
BHOPAL_GAS_HIT_WOMEN'S_FRONT_	[NGOIND]; NGO_Actors
BHOPAL_GROUP_FOR_INFORMATION_AND_ACTION_	[NGOIND]; NGO_Actors
BHUTAN_WOMEN_AND_CHILDREN_ORGANISATION_	[NGOBTNHRI]; NGO_Actors
BHUTAN_WOMEN_AND_CHILDREN_ORGANIZATION_	[NGOBTNHRI]; NGO_Actors
BOB_DENARD_	[FRAUAF] ;MleH 13 Aug 2009; AllOtherCountries.txt
BOOKS_FOR_AFRICA_	[NGOAFREDU]; NGO_Actors
BOOKS_FOR_THE_BARRIOS_	[NGOUSAEDU]; NGO_Actors
BOUTROS_BOUTROS_GHALI_	[IGOUNO 920101-961231] [ELI]; IGOrulers.txt
BREAD_FOR_THE_WORLD_INSTITUTE_	[NGOUSACHR]; NGO_Actors
BRETTON_WOODS_PROJECT_	[NGODEV]; NGO_Actors
BRIAN_MURGATROYD_	[IGOJUDICC] ;MleH 09 Aug 2009; NGO_Actors
BRITISH_COUNCIL_OF_DISABLED_PEOPLE_	[NGOGBRHRI]; NGO_Actors
BRITISH_OVERSEAS_NGOS_FOR_DEVELOPMENT_	[NGOGBRDEV]; NGO_Actors
BROOKINGS_FELLOW_	[USACVL]; AllOtherCountries.txt
BROOKINGS_INSTITUT_	[USACVL]; AllOtherCountries.txt
BUNDESTAG_	[DEULEG] ;MleH 07 Aug 2009; AllOtherCountries.txt
BUREAU_OF_INTERNATIONAL_RECYCLING_	[NGOENV]; NGO_Actors
BURMA_CAMPAIGN_UK_	[NGOMMRHRI] ;MleH 06 Aug 2009; NGO_Actors
BURMA_CENTRUM_NEDERLAND_	[NGOMMRHRI]; NGO_Actors
BURMA_HERALD_	[NGOMMRMED] ;MleH 05 Aug 2009; NGO_Actors
BURMA_LABOUR_SOLIDARITY_	[NGOMMRLAB] ;MleH 05 Aug 2009; NGO_Actors
C.S._SIDHU_	[SIK]; ReligiousGroups.txt
C._S._SIDHU_	[SIK]; ReligiousGroups.txt
CAF_INDIA_	[NGOIND]; NGO_Actors
CAF_INTERNATIONAL_	[NGO]; NGO_Actors
CALIFORNIA_INSTITUTE_OF_PUBLIC_AFFAIRS_	[USAEDU]; attached to a university; AllOtherCountries.txt
CAMILLE_GUTT_	[IGOBUSIMF 460506-510505]; IGOrulers.txt
CANADIAN_COUNCIL_FOR_REFUGEES_	[NGOCANREF]; NGO_Actors
CANADIAN_INSTITUTE_FOR_ENVIRONMENTAL_LAW_AND_POLICY_	[NGOCANENV]; NGO_Actors
CANADIAN_LAWYERS_FOR_INTERNATIONAL_HUMAN_RIGHTS_	[NGOCANHRI]; NGO_Actors
CANADIAN_NATURE_FEDERATION_	[NGOCANENV]; NGO_Actors
CANADIAN_RESEARCH_INSTITUTE_FOR_THE_ADVANCEMENT_OF_WOMEN_	[NGOCANHRI]; NGO_Actors
CARE_INTERNATIONAL_	[NGODEV]; NGO_Actors
CARIBBEAN_CONSERVATION_ASSOCIATION_	[NGOCRBENV]; NGO_Actors
CARITAS_	[NGOCHRCTH] ;MleH 13 Aug 2009; NGO_Actors
CARITAS_INTERNATIONALIS_	[NGOCHRCTH]; NGO_Actors
CARLOS SANTOS_CRUZ_	[IGOUNO] ;MleH 21 Jul 2009; NGO_Actors
CARNEGIE_ENDOWMENT_FOR_INTERNATIONAL_PEACE_	[NGOUSA]; NGO_Actors
CARTER_CENTER_	[NGOUSAHRI] ;MleH 23 Jul 2009; NGO_Actors
CASA_ALIANZA_	[NGOLAM]; NGO_Actors
CATHOLIC CENTER_OF_CONCERN_	[NGOCHRCTHHRI]; NGO_Actors
CATHOLIC_CHARITIES_USA_	[NGOCHRCTH]; NGO_Actors
CATHOLIC_INSTITUTE_FOR_INTERNATIONAL_RELATIONS_	[NGOCHRCTH]; NGO_Actors
CATO_FELLOW_	[USACVL]; AllOtherCountries.txt
CATO_INSTITUTE_	[USACVL]; AllOtherCountries.txt
CECILIA_MALMSTROM_	[IGOEUREEC 090701-091231] ; president of the CoEU from SWEDEN; IGOrulers.txt
CENTER_FOR_ECONOMIC_AND_POLICY_RESEARCH_	[USACVLBUS]; AllOtherCountries.txt
CENTER_FOR_ECONOMIC_AND_SOCIAL_RIGHTS_	[NGOHRI]; NGO_Actors
CENTER_FOR_ENVIRONMENT_AND_DEVELOPMENT_FOR_THE_ARAB_REGION_AND_EUROPE_	[NGOENV]; NGO_Actors
CENTER_FOR_HUMAN_RIGHTS_AND_DEMOCRATIC_STUDIES_	[NGONPLHRI]; NGO_Actors
CENTER_FOR_INTERNATIONAL_CLIMATE_AND_ENVIRONMENTAL_RESEARCH_	[NGONORENV]; NGO_Actors
CENTER_FOR_INTERNATIONAL_EARTH_SCIENCE_INFORMATION_NETWORK_	[NGOUSAENV]; NGO_Actors
CENTER_FOR_INTERNATIONAL_ENVIRONMENTAL_LAW_	[NGOENV]; NGO_Actors
CENTER_FOR_INTERNATIONAL_HEALTH_INFORMATION_	[NGOHLH]; NGO_Actors
CENTER_FOR_INTERNATIONAL_POLICY_	[USACVL]; AllOtherCountries.txt
CENTER_FOR_JUSTICE_AND_INTERNATIONAL_LAW_	[NGOLAMHRI]; NGO_Actors
CENTER_FOR_MIGRATION_STUDIES_	[USAEDUREF]; AllOtherCountries.txt
CENTER_FOR_REPRODUCTIVE_AND_FAMILY_HEALTH_	[NGOHLH]; NGO_Actors
CENTER_FOR_REPRODUCTIVE_LAW_AND_POLICY_	[NGOUSAHLH]; NGO_Actors
CENTER_FOR_REPRODUCTIVE_RIGHTS_	[NGOUSAHLH]; NGO_Actors
CENTER_FOR_RESPECT_OF_LIFE_AND_ENVIRONMENT_	[NGOUSACHRENV]; NGO_Actors
CENTER_FOR_SECURITY_POLICY_	[USACVL]; AllOtherCountries.txt
CENTER_FOR_STRATEGIC_AND_INTERNATIONAL_STUDIES_	[USACVL]; AllOtherCountries.txt
CENTER_FOR_SUSTAINABLE_DEVELOPMENT_	[NGOENVDEV]; NGO_Actors
CENTER_FOR_SUSTAINABLE_HUMAN_RIGHTS_ACTION_	[NGOUSAHRI]; NGO_Actors
CENTER_FOR_WOMEN'S_GLOBAL_LEADERSHIP_	[NGOHRI]; NGO_Actors
CENTER_OF_CONCERN_ORGANIZATION_	[NGOCHRCTHHRI]; NGO_Actors
CENTRAL_AMERICAN_REFUGEE_CENTER_	[NGOLAMREF]; NGO_Actors
CENTRAL_COMMITTEE_OF_CONSCIENTIOUS_OBJECTORS_	[NGOUSA]; NGO_Actors
CENTRE_FOR_AFRICAN_DEVELOPMENT_	[NGOAFRDEV]; NGO_Actors
CENTRE_FOR_DEMOCRACY_AND_DEVELOPMENT_	[NGOWAFDEV]; NGO_Actors
CENTRE_FOR_DEVELOPMENT_AND_ENTERPRISE_	[NGOZAFDEV]; NGO_Actors
CENTRE_FOR_DEVELOPMENT_AND_POPULATION_ACTIVITIES_	[NGODEV]; NGO_Actors
CENTRE_FOR_MEDIA_FREEDOM_MIDDLE_EAST_AND_NORTH_AFRICA_	[NGOMEAHRIMED]; NGO_Actors
CENTRE_FOR_THE_STUDY_OF_VIOLENCE_AND_RECONCILIATION_	[ZAFCVL]; same issue; AllOtherCountries.txt
CENTRE_ON_HOUSING_RIGHTS_AND_EVICTIONS_	[NGOHRI]; NGO_Actors
CENTRO_DE_DERECHO_AMBIENTAL_Y_DE_LOS_RECURSOS_NATURALES_	[NGOCRIENV]; NGO_Actors
CENTRO_DE_ESTUDIOS_AGRARIOS_&_AMBIENTALES_	[NGOCHLAGR]; NGO_Actors
CENTRO_ECUATORIANO_DE_DERECHO_AMBIENTAL_	[NGOECUENV]; NGO_Actors
CENTRO_MEXICANO_DE_DERECHO_AMBIENTAL_	[NGOMEXENV]; NGO_Actors
CEN_SAD_	[IGOAFRBUS] ;MleH 13 Aug 2009; NGO_Actors
CHANAN_SIDHU_	[SIK]; ReligiousGroups.txt
CHANAN_SINGH_SIDHU_	[SIK]; ReligiousGroups.txt
CHARLES_WHITELEY_	[IGOEUREEC] ;MleH 24 Jul 2009; NGO_Actors
CHILDREN'S_HOME_SOCIETY_AND_FAMILY_SERVICE_	[NGOUSA]; NGO_Actors
CHILDREN'S_HOME_SOCIETY_OF_MINNESOTA_	[NGOUSA]; NGO_Actors
CHILDREN_FIRST_INTERNATIONAL_	[NGOHRI]; NGO_Actors
CHILDREN_FIRST_NOW_	[NGOSWEHRI]; NGO_Actors
CHILDREN_SURGICAL_AID_INTERNATIONAL_	[NGOEEUHLH]; NGO_Actors
CHILDWATCH_INTERNATIONAL_RESEARCH_NETWORK_	[NGOHRI]; NGO_Actors
CHILD_LABOR_COALITION_	[NGOUSAHRI]; NGO_Actors
CHILD_LABOUR_COALITION_	[NGOUSAHRI]; NGO_Actors
CHINA_AID_ASSOCIATION_	[NGOCHNCHRHRI] ;MleH 12 Aug 2009; NGO_Actors
CHINA_DISABLED_PERSONS'_FEDERATION_	[NGOCHNHRI]; NGO_Actors
CHINA_HUMAN_RIGHTS_ORGANIZATION_	[NGOCHNHRI]; NGO_Actors
CHRISTIANS_AGAINST_TORTURE_	[NGOCHRHRI]; NGO_Actors
CHRISTIAN_SOLIDARITY_WORLDWIDE_	[NGOCHRHRI] ;MleH 06 Aug 2009; NGO_Actors
CHRISTOPHER_CAHILL_	[USACRM] ;MleH 10 Aug 2009; AllOtherCountries.txt
CHRIS_VAN_DER_KLAAUW_	[IGOEUREEC 810101-810630] ; president of the CoEU from NETHERLANDS; IGOrulers.txt
CITIZENS_FOR_GLOBAL_SOLUTIONS_	[NGOUSA]; NGO_Actors
CITIZENS_NETWORK_FOR_SUSTAINABLE_DEVELOPMENT_	[NGOUSAENV]; NGO_Actors
CITIZENS_NETWORK_ON_ESSENTIAL_SERVICES_	[NGOUSADEV]; NGO_Actors
CIVICUS_	[NGOCVL]; NGO_Actors
CIVIC_SPACE:_NGOS_UKRAINE_	[NGOUKR]; NGO_Actors
CLAUDIO_BISOGNIERO_	[IGOWSTNAT >070101]; IGOrulers.txt
CLAYTON_KUHLES_	[USACVL] ;MleH 11 Aug 2009; AllOtherCountries.txt
CLMV_	[IGOASA] ;rf 07 Jul 2009; NGO_Actors
CLOUD_FOREST_ALIVE_	[NGOCRIENV]; NGO_Actors
CLUBUL_ECOLOGIC_	[NGOROMENV]; NGO_Actors
CNN_	[USAMED] ;CTA 21 Jul 2009 and MleH 06 Aug 2009; AllOtherCountries.txt
COALITION_AGAINST_SLAVERY_IN_MAURITANIA_AND_SUDAN_	[NGOAFRHRI]; NGO_Actors
COALITION_AGAINST_WILDLIFE_TRAFFICKING_	[IGOENV] ;MleH 15 Jul 2009; NGO_Actors
COALITION_TO_STOP_THE_USE_OF_CHILD_SOLDIERS_	[NGOHRI]; NGO_Actors
COLETTE_FLESCH_	[IGOEUREEC 800701-801231] ; president of the CoEU from LUXEMBOURG; IGOrulers.txt
COMMITTEE_FOR_INTERNATIONAL_COOPERATION_IN_NATIONAL_RESEARCH_ON_DEMOGRAPHY_	[NGO]; NGO_Actors
COMMITTEE_OF_CONCERNED_SCIENTISTS_	[NGOHRI]; NGO_Actors
COMMITTEE_ON_THE_ADMINISTRATION_OF_JUSTICE_	[NGOGBRHRI]; NGO_Actors
COMMITTEE_TO_PROTECT_JOURNALISTS_	[NGOHRIMED]; NGO_Actors
COMMONWEALTH_OF_INDEPENDENT_STATES_	[IGOCASCIS]; NGO_Actors
COMMONWEALTH_OF_NATIONS_	[IGOCWN]; NGO_Actors
COMMUNITY_OF_SAHARAN_STATES_	[IGONAFCSS]; NGO_Actors
COMMUNITY_OF_SAHEL_STATES_	[IGONAFCSS]; NGO_Actors
COMMUNITY_OPTIONS,_INC._	[USAHLH]; specializing in disabled needs; AllOtherCountries.txt
COMMUNITY_SYSTEMS_FOUNDATION_	[NGO]; NGO_Actors
CONCERN_AMERICA_	[NGOUSAREF]; NGO_Actors
CONSEJO_IBERICO_PARA_LA_DEFENSA_DE_LA_NATURALEZA_	[NGOESPENV]; NGO_Actors
CONSEJO_LATINOAMERICANO_DE_CIENCIAS_SOCIALES_	[NGOLAMEDU]; NGO_Actors
CONSERVATION_INTERNATIONAL_	[NGOENV]; NGO_Actors
CONSORTIUM_FOR_STREET_CHILDREN_	[NGOHRI]; NGO_Actors
CONSTITUTIONAL_RIGHTS_PROJECT_	[NGONGAHRI]; NGO_Actors
CONSULTATIVE_GROUP_ON_INTERNATIONAL_AGRICULTURAL_RESEARCH_	[NGOAGR]; NGO_Actors
CONSUMERS_INTERNATIONAL_	[NGOBUS]; NGO_Actors
CONTRACEPTIVE_RESEARCH_AND_DEVELOPMENT_PROGRAM_	[NGOHLH]; NGO_Actors
COOPERATIVE_STATE_RESEARCH,_EDUCATION,_AND_EXTENSION_SERVICE_	[NGOUSAEDU]; Service offered through USDA for funding edu in agri; NGO_Actors
COORDINATION_COMMITTEE_OF_MAOIST_PARTIES_AND_ORGANISATIONS_IN_SOUTH_ASIA_(CCOMPOSA_)	[NGOSEA]; NGO_Actors
CORPORATE_WATCH_	[NGOBUS]; NGO_Actors
COUNCIL_OF_EUROPE_	[IGOEURCOE]; NGO_Actors
COUNCIL_OF_SECURITY_AND_COOPERATION_IN_EUROPE_	[IGOEURSCE]; NGO_Actors
COUNTERPART_INTERNATIONAL_	[NGODEV]; NGO_Actors
CS_SIDHU_	[SIK]; ReligiousGroups.txt
CULTURAL_CENTER_DEMOS_	[NGOSWEHRI]; NGO_Actors
CULTURAL_SURVIVAL,_INC_	[NGOLAMHRI]; NGO_Actors
CYNTHIA_METZLER_	[USALAB]; CEO of Experience Works (employment for seniors); AllOtherCountries.txt
C_S_SIDHU_	[SIK]; ReligiousGroups.txt
DARIEN_BOOK_AID_PLAN_	[NGOEDU]; NGO_Actors
DAVID_MATHIESON_	[NGOHRIHRW] ;MleH 06 Aug 2009; NGO_Actors
DAVID_OWEN_	[IGOEUREEC 770101-770630] ; president of the CoEU from UNITED_KINGDOM; IGOrulers.txt
DAVOS_	[CHE]; AllOtherCountries.txt
DEBBIE_STOTHARD_	[NGOMMRHRI] ;MleH 04 Aug 2009; NGO_Actors
DEEPA_MEHTA_  [CANMED] ;MleH 10 Jul 2009; AllOtherCountries.txt
DEFENCE_FOR_CHILDREN_INTERNATIONAL_	[NGOHRI]; NGO_Actors
DEMOCRACY_WATCH_	[CANDEV]; AllOtherCountries.txt
DEMOCRATIC_VOICE_OF_BURMA_	[NGOMMRMED] ;MleH 04 Aug 2009; NGO_Actors
DEMOGRAPHIC_AND_HEALTH_SURVEYS_	[NGOUSAHLH]; NGO_Actors
DERECHOS_HUMAN_RIGHTS_	[NGOLAMHRI]; NGO_Actors
DEREK_TWIGG_	[GBRGOVCVL] ;MleH 23 Jul 2009; AllOtherCountries.txt
DER_SPIEGEL_	[DEUMED] ;MleH 07 Aug 2009; AllOtherCountries.txt
DESMOND_TUTU_	[ZAFCHRPRO] ;MleH 06 Aug 2009; AllOtherCountries.txt
DEUTSCHE_	[DEU] ;MleH 11 Aug 2009; AllOtherCountries.txt
DEVELOPMENT_AGENC_	[NGODEV] ;MleH 23 Jul 2009; NGO_Actors
DEVELOPMENT_ALTERNATIVES_WITH_WOMEN_FOR_A_NEW_ERA_(DAWN)	[NGODEV]; NGO_Actors
DEVELOPMENT_GATEWAY_FOUNDATION_	[NGODEV]; NGO_Actors
DEVELOPMENT_GROUP_FOR_ALTERNATIVE_POLICIES_	[NGODEV]; NGO_Actors
DHARUBAARUGE_	[MDV] ;MleH 28 Jul 2009; AllOtherCountries.txt
DICK_SPRING_	[IGOEUREEC 960701-961231] ; president of the CoEU from IRELAND; IGOrulers.txt
DIGITALLIANCE_	[NGODEV]; Digital Alliance Foundation (ICT dev) - could also be EDU; NGO_Actors
DIGITAL_FREEDOM_NETWORK_	[NGOHRI]; NGO_Actors
DILXAT_RAXIT_	[NGOCHNUIGHRI]; NGO_Actors
DIMITRIJ_RUPEL_	[IGOEUREEC 080101-080630] ; president of the CoEU from SLOVENIA; IGOrulers.txt
DIRECTORY_OF_DEVELOPMENT_ORGANIZATIONS_	[NGODEV]; NGO_Actors
DIRECT_RELIEF_INTERNATIONAL_	[NGOHLH]; NGO_Actors
DIRK_STIKKER_	[IGOWSTNAT 610421-640801]; IGOrulers.txt
DISABILITY_AWARENESS_IN_ACTION_	[NGOHRI]; NGO_Actors
DISABLED_PEOPLES'_INTERNATIONAL_	[NGOHRI]; NGO_Actors
DOCTORS_WITHOUT_BORDERS_	[NGOHLHMSF]; SEE MEDECINS_SANS_FRONTIERES; NGO_Actors
DOHA_ROUND_TRADE_TALK_	[IGOBUSWTO] ;MleH 12 Jul 2009; NGO_Actors
DOLQUN_ISA_	[NGOCHNUIGHRI]; NGO_Actors
DOMINIQUE_STRAUSS_KAHN_	[IGOBUSIMF >071101]; IGOrulers.txt
DOUGLAS_HURD_	[IGOEUREEC 920701-921231] ; president of the CoEU from UNITED_KINGDOM; IGOrulers.txt
DUTCH_COURT_	[NLDJUD] ;ELH 29 Jul 2009; AllOtherCountries.txt
EARTHACTION_	[NGO]; NGO_Actors
EARTHSCAN_	[NGOGBRENV]; NGO_Actors
EARTHWATCH_INSTITUTE_	[NGOENV]; NGO_Actors
EARTH_ACTION_NETWORK_	[NGO]; General social action ngo; NGO_Actors
EARTH_CHARTER_INITIATIVE_	[NGOENV]; NGO_Actors
EARTH_COUNCIL_	[NGOENV]; NGO_Actors
EARTH_ISLAND_INSTITUTE_	[NGOENV]; NGO_Actors
EARTH_RIGHTS_INTERNATIONAL_	[NGOENVHRI]; NGO_Actors
EARTH_SOCIETY_FOUNDATION_	[NGOUSAENV]; NGO_Actors
EARTH_SUMMIT_WATCH_	[NGOEVN]; NGO_Actors
EARTH_TIMES_FOUNDATION_	[NGOUSAENV]; NGO_Actors
EARTH_TRUST_	[NGOENV]; NGO_Actors
EASTERN_AND_SOUTHERN_AFRICAN_TRADE_AND_DEVELOPMENT_BANK_	[IGOAFRDEVATD]; NGO_Actors
EC/UNFPA_INITIATIVE_FOR_REPRODUCTIVE_HEALTH_IN_ASIA_	[IGOUNOASAHLH]; NGO_Actors
ECOLOGICAL_SOCIETY_OF_AMERICA_	[USAENV]; AllOtherCountries.txt
ECOLOGISTAS_	[NGOESPENV]; NGO_Actors
ECONOMIC_AND_MONETARY_UNION_OF_WEST_AFRICA_	[IGOWAFUEM]; NGO_Actors
ECONOMIC_AND_SOCIAL_COMMISSION_FOR_ASIA_AND_THE_PACIFIC_	[IGOUNODEV] ;CTA 31 Jul 2009; NGO_Actors
ECONOMIC_COMMUNITY_OF_CENTRAL_AFRICAN_STATES_	[IGOCAFECA]; NGO_Actors
ECONOMIC_COMMUNITY_OF_WEST_AFRICAN_STATES_	[IGOWAFWAS]; NGO_Actors
ECOWAS_	[IGOWAFBUSWAS]; Economic Community of West African States; NGO_Actors
ECPAT_INTERNATIONAL_	[NGOTHAHRI]; NGO_Actors
EDMUND_DAUKORU_	[IGOBUSOPC] ;MleH 08 Jul 2009; NGO_Actors
EDUCATIONAL_CONCERNS_FOR_HUNGER_ORGANIZATION_	[NGOCHRAGR]; NGO_Actors
EDUCATION_INTERNATIONAL_	[NGOLABEDU]; NGO_Actors
EDUCATION_IN_HUMAN_RIGHTS_NETWORK_	[NGOUSAHRI]; NGO_Actors
EDUCATION_WITH_ENTERPRISE_TRUST_	[NGOSAFDEV]; NGO_Actors
EGALE_CANADA_	[CANHRI]; AllOtherCountries.txt
EGYPTIAN_ORGANIZATION_FOR_HUMAN_RIGHTS_	[NGOEGYHRI]; NGO_Actors
EJEVIOME_ELOH_OTOBO_	[IGOUNO] ;MleH 13 Aug 2009; NGO_Actors
EKMELEDDIN_IHSANOGLU_	[IGOMOSOIC] ;BK 22 Jul 2009; NGO_Actors
ELEANOR_ROOSEVELT_CENTER_AT_VAL_KILL_	[USACVL]; AllOtherCountries.txt
ELIZABETH_AIKEN_FREUND_	[USALAB]; AllOtherCountries.txt
EMILIO_COLOMBO_	[IGOEUREEC 620701-621231] ; president of the CoEU from ITALY; IGOrulers.txt
EMPOWERMENT_FOR_AFRICAN_SUSTAINABLE_DEVELOPMENT_	[NGOAFRENV]; NGO_Actors
ENGENDERHEALTH_	[NGOHLH]; NGO_Actors
ENTERPRISE_DEVELOPMENT_INTERNATIONAL_	[NGOCHRDEV]; NGO_Actors
ENVIRONMENTAL_DEFENSE_	[USAENV]; AllOtherCountries.txt
ENVIRONMENT_LIAISON_CENTER_INTERNATIONAL_	[NGOENV]; NGO_Actors
EQUALITY_NOW_	[NGOHRI]; Women's Rights; NGO_Actors
EQUIPO_NIZKOR_	[NGOLAMHRI]; NGO_Actors
ERIC_DA_RIN_	[IGOWSTNAT 810101-851231]; IGOrulers.txt
ERIC_J._ROSBORG_	[USAMIL] ;MleH 09 Aug 2009; AllOtherCountries.txt
ERIC_SOLHEIM_	[NORGOVDEV] ;MleH 23 Jul 2009; AllOtherCountries.txt
ESTONIAN_AMERICAN_FUND_FOR_ECONOMIC_EDUCATION,_INC_	[NGOESTDEV]; NGO_Actors
EUGENE_BLACK_	[IGOUNODEVWBK 490101-631231]; IGOrulers.txt
EUGENE_MEYER_	[IGOUNODEVWBK 460601-461231]; IGOrulers.txt
EUGENE_R._BLACK_	[IGOUNODEVWBK 490101-630131]; IGOrulers.txt
EUGENE_R_BLACK_	[IGOUNODEVWBK 490101-631231]; IGOrulers.txt
EUGENE_SCHAUS_	[IGOEUREEC 600101-600630][IGOEUREEC 630101-630630] ; president of the CoEU from LUXEMBOURG; IGOrulers.txt
EURASIA_FOUNDATION_	[NGOCAUDEV]; NGO_Actors
EURONGOS_	[NGOEURHLH]; NGO_Actors
EUROPARC_FEDERATION_	[IGOEURENV]; it has both governments and corporations as members; NGO_Actors
EUROPE_	[EUR] ;MleH 23 Jul 2009	and ELH 06 Jul 2009; AllOtherCountries.txt
EUROPEAN_	[EUR] ;MleH 11 Aug 2009; AllOtherCountries.txt
EUROPEAN_BANK_FOR_RECONSTRUCTION_AND_DEVELOPMENT_	[IGOEURDEVEBR]; NGO_Actors
EUROPEAN_BAR_HUMAN_RIGHTS_INSTITUTE_	[NGOEURHRI]; NGO_Actors
EUROPEAN_CENTRE_FOR_NATURE_CONSERVATION_	[NGOEURENV]; NGO_Actors
EUROPEAN_COMMISSION_	[IGOEUREEC] ;MleH 21 Jul 2009 et al.; NGO_Actors
EUROPEAN_COMMISSION_TO_THE_PHILIPPINES_	[IGOEUREEC] ;ELH 17 Jul 2009; NGO_Actors
EUROPEAN_COUNCIL_ON_REFUGEES_AND_EXILES_	[NGOEURREF]; NGO_Actors
EUROPEAN_ENVIRONMENTAL_BUREAU_	[NGOEURENV]; NGO_Actors
EUROPEAN_FREE_TRADE_ASSOCIATION_	[IGOEURBUSEFT]; NGO_Actors
EUROPEAN_PARLIAMENT_	[IGOEUREEC] ;MleH 17 Jul 2009; NGO_Actors
EUROPEAN_PUBLIC_LAW_CENTER_	[NGOEURJUD]; NGO_Actors
EUROPEAN_UNION_	[IGOEUREEC]; NGO_Actors
EXPERT_CHAD_HALL_	[USABUS]; bomb disposal expert, arrested; AllOtherCountries.txt
FAILED_STATE_	[UIS]; maybe return to null code; AllOtherCountries.txt
FAMILY_CARE_INTERNATIONAL_	[NGOHLH]; NGO_Actors
FAMILY_HEALTH_INTERNATIONAL_	[NGOHLH]; NGO_Actors
FARS_NEWS_	[IRNMED] ;MleH 15 Jul 2009; AllOtherCountries.txt
FAUNA_&_FLORA_INTERNATIONAL_	[NGOENV]; NGO_Actors
FAUNA_AND_FLORA_INTERNATIONAL_	[NGOENV]; NGO_Actors
FBI_	[USACOP] ;MleH 24 Jul 2009; AllOtherCountries.txt
FEDERATION_OF_AMERICAN_WOMEN'S_CLUBS_OVERSEAS_	[NGOUSA]; NGO_Actors
FEED_THE_CHILDREN_	[NGOCHRHLH]; NGO_Actors
FEMINISTS_FOR_FREE_EXPRESSION_	[USACVL]; AllOtherCountries.txt
FIDH_	[NGOHRIFID]; Intl Fed of Human Rights; NGO_Actors
FOODFIRST_INFORMATION_AND_ACTION_NETWORK_	[NGOHRI]; NGO_Actors
FOOD_FIRST_INFORMATION_AND_ACTION_NETWORK_	[NGOHRI]; NGO_Actors
FOREIGNAID_500	[NGODEV]; NGO_Actors
FOREIGN_NATIONAL_	[INT] ;MleH 28 Jul 2009; AllOtherCountries.txt
FOREST,_TREES_AND_PEOPLE_PROGRAM_	[NGOENV]; NGO_Actors
FORUM_FOR_THE_FUTURE_	[NGOGBRENVDEV]; NGO_Actors
FOUNDATION_FOR_EDUCATION_FOR_DEMOCRACY_	[NGOPOLDEV]; NGO_Actors
FOUNDATION_FOR_INTERNATIONAL_ENVIRONMENTAL_LAW_AND_DEVELOPMENT_	[NGOGBRENV]; NGO_Actors
FOUNDATION_FOR_THE_PEOPLES_OF_ASIA_AND_THE_PACIFIC_	[NGOAUSDEV]; NGO_Actors
FOUNDATION_FOR_THE_PEOPLES_OF_THE_SOUTH_PACIFIC_	[NGOAUSDEV]; NGO_Actors
FRANCISCO_FERNANDEZ_ORDONEZ_	[IGOEUREEC 890101-890630] ; president of the CoEU from SPAIN; IGOrulers.txt
FRANC_ZONE_FINANCIAL_COMMUNITY_OF_AFRICA_	[IGOAFRBUSCFA]; NGO_Actors
FREDERICK_VAN_ZYL_SLABBERT_	[ZAFEDU] ;MleH 14 Jul 2009; AllOtherCountries.txt
FREDERIK_WILLEM_DE_KLERK_	[ZAFELI] ;MleH 12 Aug 2009; AllOtherCountries.txt
FREEDOM_FROM_RELIGION_FOUNDATION_	[USAATH] ;MleH 12 Aug 2009; AllOtherCountries.txt
FREEDOM_TO_MARRY_	[USAHRI]; AllOtherCountries.txt
FREE_BURMA_COALITION_	[NGOMMRHRI]; NGO_Actors
FRIENDS_OF_THE_EARTH_	[NGOENV]; NGO_Actors
FSM_ASSOCIATION_OF_NGO'S	[NGOFSM]; Gender, environment, governance issues in Micronesia; NGO_Actors
FUNDACION_DESARROLLO_SOSTENIDO_	[NGOESPDEV]; NGO_Actors
FUTURES_GROUP_INTERNATIONAL_	[NGOHLH]; NGO_Actors
GARRET_FITZGERALD_	[IGOEUREEC 750101-750630] ; president of the CoEU from IRELAND; IGOrulers.txt
GATES_FOUNDATION_	[NGOUSA] ;MleH 10 Aug 2009; NGO_Actors
GAY_AND_LESBIAN_ALLIANCE_AGAINST_DEFAMATION_	[USAMED]; AllOtherCountries.txt
GCS_INTERNATIONAL_	[NGOKOR]; NGO_Actors
GCS_MOVEMENT_	[NGOKOR]; NGO_Actors
GENERAL_FEDERATION_OF_WOMEN'S_CLUBS_	[NGOUSA]; NGO_Actors
GENERAL_LORD_ISMAY_	[IGOWSTNAT 520401-570516] ; secretaries general; IGOrulers.txt
GEOFFREY_HOWE_	[IGOEUREEC 860701-861231] ; president of the CoEU from UNITED_KINGDOM; IGOrulers.txt
GEORGE_ALOGOSKOUFIS_	[GRCGOVBUS] ;MleH 10 Aug 2009; AllOtherCountries.txt
GEORGE_D._WOODS_	[IGOUNODEVWBK 630101-680331]; IGOrulers.txt
GEORGE_D_WOODS_	[IGOUNODEVWBK 630101-680331]; IGOrulers.txt
GEORGE_PAPANDREOU_	[IGOEUREEC 030101-030630] ; president of the CoEU from GREECE; IGOrulers.txt
GEORGE_WOODS_	[IGOUNODEVWBK 630101-680331]; IGOrulers.txt
GERRY_COLLINS_	[IGOEUREEC 900101-900630] ; president of the CoEU from IRELAND; IGOrulers.txt
GIANNI_DE_MICHELIS_	[IGOEUREEC 900701-901231] ; president of the CoEU from ITALY; IGOrulers.txt
GILLIAN_MELLSOP_	[IGOUNOKID] ;MleH 23 Jul 2009; NGO_Actors
GIUSEPPE_MEDICI_	[IGOEUREEC 680701-681231] ; president of the CoEU from ITALY; IGOrulers.txt
GIUSEPPE_PELLA_	[IGOEUREEC 590701-591231] ; president of the CoEU from ITALY; IGOrulers.txt
GLADWYN_JEBB_	[IGOUNO 451024-460201] [ELI]; IGOrulers.txt
GLOBAL_AIDS_COLLABORATIVE_FOR_CARE,_TREATMENT_AND_SUPPORT_	[NGOHLH]; NGO_Actors
GLOBAL_ALLIANCE_FOR_WOMEN'S_HEALTH_	[NGOHLH]; NGO_Actors
GLOBAL_DEVELOPMENT_NETWORK_	[NGODEV]; NGO_Actors
GLOBAL_FUND_FOR_HIV AIDS_	[NGOSWZHLH] ;CTA 24 Jul 2009; NGO_Actors
GLOBAL_FUND_FOR_WOMEN_	[NGOHRI]; NGO_Actors
GLOBAL_LAWYERS_AND_PHYSICIANS_	[NGOHLHHRI]; NGO_Actors
GLOBAL_LEAD_NETWORK_	[NGOHLH]; it's about health, but functions much like environmentalism; NGO_Actors
GLOBAL_VISION_INTERNATIONAL_	[NGOGBR]; NGO_Actors
GLOBAL_WITNESS_	[NGOENVHRI]; NGO_Actors
GOOD_NEIGHBORS_INTERNATIONAL_	[NGODEV]; NGO_Actors
GRAEME_WHEELER_	[IGOUNOWBK] ;MleH 22 Jul 2009; NGO_Actors
GRASSROOTS_INTERNATIONAL_	[NGOHRI]; NGO_Actors
GREAT_JAMAHIRIYAH_	[LBY] ;MleH 15 Jul 2009; AllOtherCountries.txt
GREENPEACE_	[NGOENV]; NGO_Actors
GREENPEACE_HONG_KONG_	[NGOHKGENV]; NGO_Actors
GREEN_CROSS_INTERNATIONAL_	[NGOENV]; NGO_Actors
GREEN_EARTH_ORGANIZATION_	[NGOGHAENV]; NGO_Actors
GREEN_FRONT_OF_IRAN_	[NGOIRNENV]; NGO_Actors
GRIGORIS_VARFIS_	[IGOEUREEC 830701-831231] ; president of the CoEU from GREECE; IGOrulers.txt
GROUP_OF_EIGHT_	[IGOBUSGOE]; NGO_Actors
GROUP_OF_SEVEN_	[IGOBUSGOS]; NGO_Actors
GROUP_OF_SEVENTY_SEVEN_	[IGOBUSGSS]; NGO_Actors
GUIDE_TO_NGOS_IN_PAKISTAN_	[NGOPAK]; NGO_Actors
GUIDO_COLONNA_DI_PALIANO_	[IGOWSTNAT 620101-641231]; IGOrulers.txt
GULF_ARAB_STATE_	[ARBUIS]; AllOtherCountries.txt
GULF_COOPERATION_COUNCIL_	[IGOPGSGCC]; NGO_Actors
GURU_NANAK_FOUNDATION_	[SIK]; ReligiousGroups.txt
GURU_TEG_BAHADUR FOUNDATION_	[SIK]; ReligiousGroups.txt
GUTTMACHER_INSTITUTE_	[NGOUSAHLH]; NGO_Actors
GYULA_THURMER_	[HUNOPPPTY] ;MleH 09 Aug 2009; AllOtherCountries.txt
G_7_	[IGOGOS]; Group of Seven (excludes Russia); NGO_Actors
G_8_	[IGOGOE]; Group of Eight (includes Russia); NGO_Actors
HABITAT_INTERNATIONAL_COALITION_	[NGOHRI]; NGO_Actors
HAITIAN_MOVEMENT_FOR_RURAL_DEVELOPMENT_	[NGOHTIDEV]; NGO_Actors
HAMMARSKJOLD_	[IGOUNO 530410-610918] [ELI]; IGOrulers.txt
HANIF_HAMGAM_  [AFGELI] ;MleH 07 Jul 2009; AllOtherCountries.txt
HANS_DIETRICH GENSCHER_	[IGOEUREEC 780701-781231][IGOEUREEC 830101-830630][IGOEUREEC 880101-880630] ; president of the CoEU from WEST_GERMANY; IGOrulers.txt
HANS_VAN_DEN_BROEK_	[IGOEUREEC 860101-860630][IGOEUREEC 910701-911231] ; president of the CoEU from NETHERLANDS; IGOrulers.txt
HANS_VAN_MIERLO_	[IGOEUREEC 970101-970630] ; president of the CoEU from NETHERLANDS; IGOrulers.txt
HARBANS_SINGH_	[SIK]; ReligiousGroups.txt
HARVARD HUMAN_RIGHTS_INTERNET_	[NGOHRI]; a little bit jerry-rigged; NGO_Actors
HAUSER_CENTER_FOR_NONPROFIT_ORGANIZATIONS_	[USAEDU]; researches NGO's; AllOtherCountries.txt
HAWAIIAN_AIRLINES_	[USABUS] ;ELH 30 Jul 2009; AllOtherCountries.txt
HEALTHWRIGHTS_	[NGOHRIHLH]; NGO_Actors
HEALTH_OPPORTUNITIES_FOR_PEOPLE_EVERYWHERE_	[NGOUSAHLH]; NGO_Actors
HEALTH_VOLUNTEERS_OVERSEAS_	[NGOHLH]; NGO_Actors
HEIFER_INTERNATIONAL_	[NGODEVAGR]; NGO_Actors
HEILIGENDAMM_	[DEU] ;MleH 29 Jul 2009; AllOtherCountries.txt
HELEN_CAMPBELL_	[IGOEUREEC] ;MleH 24 Jul 2009; NGO_Actors
HELSINKI_FOUNDATION_FOR_HUMAN_RIGHTS_	[NGOHRI]; it's not clear whether its members are governments; NGO_Actors
HENDRIK_FAYAT_	[IGOEUREEC 640101-640630] ; president of the CoEU from BELGIUM; IGOrulers.txt
HENRI_SIMONET_	[IGOEUREEC 770701-771231] ; president of the CoEU from BELGIUM; IGOrulers.txt
HERITAGE_FOUNDATION_	[USACVL]; AllOtherCountries.txt
HESPERIAN_FOUNDATION_	[NGOHLHEDU]; spreads health information; NGO_Actors
HIGHLY_INDEBTED_POOR_COUNTRIES_	[IGOBUSHIP]; NGO_Actors
HIJRA_INTERNATIONAL_	[NGOMOSHRI]; NGO_Actors
HINDU_WORLD_COUNCIL_	[NGOHINRAD]; NGO_Actors
HIPC_	[IGOBUSHIP]; Highly Indebted Poor Countries; NGO_Actors
HOLY_SEE_	[VAT] ;ELH 06 Aug 2009; AllOtherCountries.txt
HUBERT_VEDRINE_	[IGOEUREEC 000701-001231] ; president of the CoEU from FRANCE; IGOrulers.txt
HUMAN_RIGHTS_ACTION_CENTER_	[NGOMMRHRI] ;MleH 05 Aug 2009; NGO_Actors
HUMAN_RIGHTS_CENTER_OF_AZERBAIJAN_	[NGOAZEHRI]; NGO_Actors
HUMAN_RIGHTS_CONGRESS_FOR_BANGLADESH_MINORITIES_	[NGOBGDHRI]; NGO_Actors
HUMAN_RIGHTS_FIRST_	[NGOUSAHRI]; NGO_Actors
HUMAN_RIGHTS_FOUNDATION_OF_TURKEY_	[NGOTURHRI]; NGO_Actors
HUMAN_RIGHTS_GROUP_	[NGOHRI] ;MleH 24 Jul 2009; NGO_Actors
HUMAN_SCIENCES_RESEARCH_COUNCIL_	[NGOZAFDEV]; NGO_Actors
HUMAN_STRATEGIES_FOR_HUMAN_RIGHTS_	[NGOHRI]; NGO_Actors
HUNGARIAN_COMMUNIST_WORKERS'_PARTY_	[HUNOPPPTY] ;MleH 09 Aug 2009; AllOtherCountries.txt
HUTU_DEMOCRATIC_FORCES_	[RWAINS] ;MleH 10 Aug 2009; AllOtherCountries.txt
IAEA_	[IGOUNOIAE]; Intl Atomic Energy Agency; NGO_Actors
ICCO_	[IGOAGRICO]; Intl Cocoa Org., very very iffy; NGO_Actors
ICC_	[IGOJUDICC] ;MleH 09 Aug 2009; NGO_Actors
ICJ_	[IGOUNOJUDICJ]; Intl Court of Justice; NGO_Actors
ICRC_	[NGOHLHIRC]; part of Intl Red Cross & Red Crescent Movement; NGO_Actors
IEARN_USA_	[NGOUSAEDU]; internet & digital media for education K-12; NGO_Actors
IFCO/PASTORS_FOR_PEACE_	[NGOCHRHRI]; NGO_Actors
IGAD_	[IGODEVIAD]; Inter-Govt Authority on Development; NGO_Actors
IGC_INTERNET_	[NGOMED]; NGO_Actors
IMF_	[IGOBUSIMF]; Intl Monetary Fund; NGO_Actors
INDIAN_OCEAN_COMMISSION_	[IGOAFR] ;MleH 09 Jul 2009; NGO_Actors
INDIAN_UN_PEACEKEEPER_	[IGOUNO] ;MleH 10 Aug 2009; NGO_Actors
INDO_BANGLADESH_JOINT_RIVERS_COMMISSION_	[IGOSASDEV]; NGO_Actors
INDO_BANGLA_JOINT_RIVER_COMMISSION_	[IGOSASDEV]; NGO_Actors
INSTITUTE_FOR_DEVELOPMENT_ANTHROPOLOGY_	[NGOEDUDEV]; NGO_Actors
INSTITUTE_FOR_DEVELOPMENT_RESEARCH_AMSTERDAM_	[NGONLDEDUDEV]; NGO_Actors
INSTITUTE_FOR_GLOBAL_COMMUNICATIONS_	[NGOMED]; NGO_Actors
INSTITUTE_FOR_HUMAN_RIGHTS_AND_DEVELOPMENT_IN_AFRICA_	[NGOAFRHRIDEV]; NGO_Actors
INSTITUTE_FOR_INTERNATIONAL_COOPERATION_AND_DEVELOPMENT_	[NGODEV]; NGO_Actors
INSTITUTE_FOR_MULTI_TRACK_DIPLOMACY_	[NGOUSA]; NGO_Actors
INSTITUTE_FOR_SCIENCE_AND_INTERNATIONAL_SECURITY_	[NGOUSA] ;MleH 09 Jul 2009; NGO_Actors
INSTITUTE_OF_DEVELOPMENT_STUDIES_	[GBREDUDEV]; AllOtherCountries.txt
INSTITUTE_OF_INTERNATIONAL_FINANCE_	[NGOBUS] ;MleH 09 Jul 2009 09 Jul 2009; NGO_Actors
INSTITUTE_OF_WORLD_AFFAIRS_	[USAEDU]; potentially CVL; AllOtherCountries.txt
INSTITUTO_DE_DERECHO_Y_ECONOMIA_AMBIENTAL_	[NGOPRYENV]; NGO_Actors
INSTITUTO_DE_DESARROLLO_Y_MEDIO_AMBIENTE_	[NGOPERDEV]; NGO_Actors
INTERCHURCH_MEDICAL_ASSISTANCE_INC_	[NGOCHRPROHLH]; NGO_Actors
INTERGOVERNMENTAL_AUTHORITY_ON_DEVELOPMENT_	[IGOEAFDEVIAD]; NGO_Actors
INTERGOVERNMENTAL_PANEL_ON_CLIMATE_CHANGE_	[IGOUNOENV] ;MleH 11 Aug 2009; NGO_Actors
INTERHEMISPHERIC_RESOURCE_CENTER_	[USAEDU]; AllOtherCountries.txt
INTERIGHTS_	[NGOHRIJUD]; NGO_Actors
INTERMEDIATE_TECHNOLOGY_DEVELOPMENT_GROUP_	[NGOGBRDEV]; NGO_Actors
INTERNATIONAL_ACADEMY_OF_ARCHITECTURE_	[NGOUER]; NGO_Actors
INTERNATIONAL_ADVOCATES_FOR_CHILDREN_	[NGOHRI]; Children's rights etc.; NGO_Actors
INTERNATIONAL_AGENCY_FOR_ECONOMIC_DEVELOPMENT_	[NGODEV]; NGO_Actors
INTERNATIONAL_ALERT_	[NGODEV]; NGO_Actors
INTERNATIONAL_ALLIANCE_OF_WOMEN_	[NGOHRI]; NGO_Actors
INTERNATIONAL_ASSOCIATION_FOR_NATURAL_GAS_VEHICLES_	[NGOBUS]; NGO_Actors
INTERNATIONAL_ASSOCIATION_OF_AGRICULTURAL_INFORMATION_SPECIALISTS_	[NGOAGREDU]; NGO_Actors
INTERNATIONAL_ASSOCIATION_ON_WATER_QUALITY_	[NGOENV]; NGO_Actors
INTERNATIONAL_ATOMIC_ENERGY_AGENCY_	[IGOUNOIAE]; NGO_Actors
INTERNATIONAL_BOOK_BANK,_INC_	[NGOEDU]; NGO_Actors
INTERNATIONAL_BOOK_PROJECT,_INC_	[NGOEDU]; NGO_Actors
INTERNATIONAL_CAMPAIGN_TO_BAN_LANDMINES_	[NGOHRI] ;MleH 11 Aug 2009; NGO_Actors
INTERNATIONAL_CENTER_FOR_DIARRHOEAL_DISEASE_RESEARCH_	[NGOBGHHLH]; NGO_Actors
INTERNATIONAL_CENTRE_FOR_INTEGRATED_MOUNTAIN_DEVELOPMENT_	[NGOASAENV]; NGO_Actors
INTERNATIONAL_CENTRE_FOR_RESEARCH_IN_AGROFORESTRY_	[NGOAGR]; NGO_Actors
INTERNATIONAL_CHAMBER_OF_COMMERCE_	[NGOBUS]; NGO_Actors
INTERNATIONAL_CLINICAL_EPIDEMIOLOGY_NETWORK_	[NGOHLH]; NGO_Actors
INTERNATIONAL_COCOA_ORGANIZATION_	[IGOAGRICO]; NGO_Actors
INTERNATIONAL_COMMISSION_OF_JURISTS_	[NGOJUDJUR]; NGO_Actors
INTERNATIONAL_COMMISSION_OF_MISSING_PERSONS_	[NGOBLK]; NGO_Actors
INTERNATIONAL_COMMITTEE_OF_SOLIDARITY_FOR_POLITICAL_PRISONERS_IN_TUNISIA_	[NGOTUNHRI]; NGO_Actors
INTERNATIONAL_COMMITTEE_OF_THE_RED_CROSS_	[NGOHLHIRC]; part of Intl Red Cross & Red Crescent Movement; NGO_Actors
INTERNATIONAL_COMMUNITY_	[INT] ;MleH 28 Jul 2009; AllOtherCountries.txt
INTERNATIONAL_COMMUNITY_OF_WOMEN_LIVING_WITH_HIV/AIDS_	[NGOHLH]; NGO_Actors
INTERNATIONAL_CONFEDERATION_OF_FREE_TRADE_UNIONS_	[NGOLAB]; NGO_Actors
INTERNATIONAL_COUNCIL_OF_ENVIRONMENTAL_LAW_	[NGOENV]; NGO_Actors
INTERNATIONAL_COUNCIL_OF_JEWISH_WOMEN_	[NGOJEWHRI]; NGO_Actors
INTERNATIONAL_COUNCIL_OF_VOLUNTARY_AGENCIES_	[NGOHRI]; NGO_Actors
INTERNATIONAL_COURT_OF_JUSTICE_	[IGOUNOJUDICJ]; NGO_Actors
INTERNATIONAL_CRIMINAL_COURT_	[IGOJUDICC]; NGO_Actors
INTERNATIONAL_CRISIS_GROUP_	[NGOICG]; NGO_Actors
INTERNATIONAL_DEVELOPMENT_EXCHANGE_	[NGODEV]; NGO_Actors
INTERNATIONAL_DEVELOPMENT_RESEARCH_CENTRE_	[NGODEV]; NGO_Actors
INTERNATIONAL_ENERGY_AGENCY_	[IGOUNOAIE] ;MleH 06 Jul 2009; NGO_Actors
INTERNATIONAL_FED._OF_RED_CROSS_AND_RED_CRESCENT_	[NGOHLHIRC]; part of Intl Red Cross & Red Crescent Movement; NGO_Actors
INTERNATIONAL_FEDERATION_OF_ACTION_BY_CHRISTIANS_FOR_THE_ABOLITION_OF_TORTURE_	[NGOCHRHRI]; NGO_Actors
INTERNATIONAL_FEDERATION_OF_HEALTH_AND_HUMAN_RIGHTS_ORGANISATIONS_	[NGOHLH]; NGO_Actors
INTERNATIONAL_FEDERATION_OF_HUMAN_RIGHTS_	[NGOHRIFID]; NGO_Actors
INTERNATIONAL_FEDERATION_OF_JOURNALISTS_	[NGOMED] ;ELH 09 Jul 2009 + BK 22 Jul 2009 + MleH 06 Aug 2009; NGO_Actors
INTERNATIONAL_FEDERATION_OF_RED_CROSS_AND_RED_CRESCENT_	[NGOHLHIRC]; part of Intl Red Cross & Red Crescent Movement; NGO_Actors
INTERNATIONAL_FEDERATION_OF_UNIVERSITY_WOMEN_	[NGOEDU]; NGO_Actors
INTERNATIONAL_FOUNDATION_FOR_ELECTORAL_SYSTEMS_	[NGO]; NGO_Actors
INTERNATIONAL_FREEDOM_OF_EXPRESSION_EXCHANGE_	[NGOMED]; NGO_Actors
INTERNATIONAL_GAY_AND_LESBIAN_HUMAN_RIGHTS_COMMISSION_	[NGOHRI]; NGO_Actors
INTERNATIONAL_GEOGRAPHICAL_UNION_	[NGO]; NGO_Actors
INTERNATIONAL_HELSINKI_FEDERATION_FOR_HUMAN_RIGHTS_	[NGOHRIIHF]; NGO_Actors
INTERNATIONAL_HUMAN_RIGHTS_ASSOCIATION_OF_AMERICAN_MINORITIES_	[NGOHRI]; NGO_Actors
INTERNATIONAL_HUMAN_RIGHTS_INTERNSHIP_PROGRAM_	[NGOHRI]; NGO_Actors
INTERNATIONAL_HUMAN_RIGHTS_LAW_GROUP_	[NGOHRI]; NGO_Actors
INTERNATIONAL_IMMIGRANTS_FOUNDATION_	[USACVLREF]; AllOtherCountries.txt
INTERNATIONAL_INDEPENDENT_GROUP_OF_EMINENT_PERSONS_	[NGOLKAHRI] ;MleH 28 Jul 2009; NGO_Actors
INTERNATIONAL_INDIAN_TREATY_COUNCIL_	[NGOHRI]; NGO_Actors
INTERNATIONAL_INSTITUTE_FOR_ENVIRONMENT_AND_DEVELOPMENT_	[NGOGBRENV]; NGO_Actors
INTERNATIONAL_INSTITUTE_FOR_SUSTAINABLE_DEVELOPMENT_	[NGOCANENV]; NGO_Actors
INTERNATIONAL_LABOR_ORGANIZATION_	[IGOUNOLABILO]; NGO_Actors
INTERNATIONAL_LEAGUE_FOR_HUMAN_RIGHTS_	[NGOHRI]; NGO_Actors
INTERNATIONAL_LEAGUE_OF_HUMAN_RIGHTS_	[NGOHRI]; NGO_Actors
INTERNATIONAL_LESBIAN_AND_GAY_ASSOCIATION_	[NGOHRI]; NGO_Actors
INTERNATIONAL_MATHEMATICAL_UNION_	[NGOEDU]; NGO_Actors
INTERNATIONAL_MEDIA_RIGHTS_	[NGOHRI] ;MleH 27 Jul 2009; NGO_Actors
INTERNATIONAL_MONETARY_FUND_	[IGOBUSIMF]; NGO_Actors
INTERNATIONAL_NETWORK_FOR_THE_RATIONAL_USE_OF_DRUGS_	[NGOHLH]; NGO_Actors
INTERNATIONAL_OFFICE_FOR_WATER_	[NGOENV]; could add HLH, because of the human effect; NGO_Actors
INTERNATIONAL_OLIVE_COUNCIL_	[NGOAGR] ;MleH 10 Aug 2009; NGO_Actors
INTERNATIONAL_ORGANIZATION_FOR_MIGRATION_	[IGOREFIOM]; NGO_Actors
INTERNATIONAL_PETROLEUM_INDUSTRY_ENVIRONMENTAL_CONSERVATION_	[NGOENV]; NGO_Actors
INTERNATIONAL_PLANNED_PARENTHOOD_FEDERATION_	[NGOHLH]; NGO_Actors
INTERNATIONAL_PLATFORM_OF_JURISTS_FOR_EAST_TIMOR_	[NGOTMPHRI]; NGO_Actors
INTERNATIONAL_RESEARCH_FOUNDATION_FOR_DEVELOPMENT_	[NGODEV]; consultative status with ECOSOC (UN); NGO_Actors
INTERNATIONAL_RICE_RESEARCH_INSTITUTE_	[NGOAGR] ;MleH 07 Aug 2009; NGO_Actors
INTERNATIONAL_RIVERS_NETWORK_	[NGOUSAENV]; NGO_Actors
INTERNATIONAL_SNOW_LEOPARD_TRUST_	[NGOENV]; animal rights; NGO_Actors
INTERNATIONAL_SOCIETY_FOR_HEALTH_AND_HUMAN_RIGHTS_	[NGOHRIHLH]; NGO_Actors
INTERNATIONAL_SOCIETY_OF_TROPICAL_FORESTERS_	[NGOENV]; NGO_Actors
INTERNATIONAL_SOUTH_GROUP_NETWORK_	[NGODEV]; NGO_Actors
INTERNATIONAL_TRAINING_CENTRE_ON_HUMAN_RIGHTS_AND_PEACE_TEACHING_	[NGOHRI]; NGO_Actors
INTERNATIONAL_TRUCE_MONITORING_GROUP_	[IGO] ;MleH 24 Jul 2009; NGO_Actors
INTERNATIONAL_UNION_FOR_THE_CONSERVATION_OF_NATURE_	[NGOENV]; NGO_Actors
INTERNATIONAL_UNION_OF_BASIC_AND_CLINICAL_PHARMACOLOGY_	[NGOHLH]; NGO_Actors
INTERNATIONAL_UNION_OF_GEODESY_AND_GEOPHYSICS_	[NGOEDU]; NGO_Actors
INTERNATIONAL_UNION_OF_PURE_AND_APPLIED_CHEMISTRY_	[NGOEDU]; NGO_Actors
INTERNATIONAL_UNION_OF_PURE_AND_APPLIED_PHYSICS_	[NGOEDU]; NGO_Actors
INTERNATIONAL_UYGHUR_YOUTH_LEAGUE_	[NGOCHNUIGHRI]; NGO_Actors
INTERNATIONAL_WAR_CRIMES_TRIBUNAL_	[IGOUNOJUDWCT]; NGO_Actors
INTERNATIONAL_WATER_MANAGEMENT_INSTITUTE_	[NGOAGR]; NGO_Actors
INTERNATIONAL_WILDLIFE_COALITION_	[NGOENV]; NGO_Actors
INTERNATIONAL_WOMEN'S_HEALTH_COALITION_	[NGOHLH]; NGO_Actors
INTERNATIONAL_WOMEN'S_RIGHTS_ACTION_WATCH_	[NGOHRI]; NGO_Actors
INTERNATIONAL_WORK_GROUP_FOR_INDIGENOUS_AFFAIRS_	[NGOHRI]; NGO_Actors
INTERNATIONAL_YOUTH_FOUNDATION_	[NGODEV]; improving kids' lives, skills, etc., mostly in poor areas; NGO_Actors
INTERNET_SOCIETY_	[NGOMED]; NGO_Actors
INTERNEWS_	[NGOMED] ;MleH 28 Jul 2009; NGO_Actors
INTERPOL_	[IGOCOPITP]; NGO_Actors
INTERPROFESSIONAL_FOSTERING_OF_OPHTHALMIC_CARE_FOR_UNDERSERVED_SECTORS_	[NGOHLH]; NGO_Actors
INTERRELIGIOUS_AND_INTERNATIONAL_FEDERATION_FOR_WORLD_PEACE_	[NGOREL]; NGO_Actors
INTER_AFRICAN_COFFEE_ORGANIZATION_	[IGOAFRAGRIAC]; NGO_Actors
INTER_AFRICA_GROUP_	[NGOSAF]; NGO_Actors
INTER_AMERICAN_INSTITUTE_OF_HUMAN_RIGHTS_	[NGOLAMHRI]; NGO_Actors
INTER_GOVERNMENTAL_PANEL_ON_CLIMATE_CHANGE_	[IGOUNOENV] ;MleH 11 Aug 2009; NGO_Actors
INTER_PARLIAMENTARY_UNION_	[IGOLEGIPU]; NGO_Actors
INTRAHEALTH_INTERNATIONAL_INC_	[NGOHLH]; NGO_Actors
INVENEO_	[NGOMED]; Internet Communications Technologies; NGO_Actors
IPU_	[IGOIPU] ;MleH 07 Aug 2009; NGO_Actors
IRANIAN_OIL_COMPANY_	[IRNBUS] ;BK 29 Jul 2009; AllOtherCountries.txt
ISAR_	[NGOENV]; International Society for Animal Rights; NGO_Actors
ISIS_INTERNATIONAL_MANILA_	[NGOPHLMED]; NGO_Actors
ISLAMIC_DEVELOPMENT_BANK_	[IGOMOSDEVIDB]; NGO_Actors
ISLAMIC_WORLD_	[MOS] ;BK 07 Jul 2009; AllOtherCountries.txt
ISRAELI_INFORMATION_CENTER_FOR_HUMAN_RIGHTS_IN_THE_OCCUPIED_TERRITORIES_	[NGOISRHRI]; NGO_Actors
THIRD_WORLD_INSTITUTE_	[NGOURYDEV]; NGO_Actors
ITTIPAK_	[NGOCHNUIGHRI]; NGO_Actors
IVAR_NORGAARD_	[IGOEUREEC 730701-731231] ; president of the CoEU from DENMARK; IGOrulers.txt
IVAR_ROOTH_	[IGOBUSIMF 510803-561003]; IGOrulers.txt
IWOKRAMA_INTERNATIONAL_CENTRE_FOR_RAIN_FOREST_CONSERVATION_AND_DEVELOPMENT_	[NGOGUYENV]; NGO_Actors
IWUCHUKWU_	[NGACRM] ;MleH 07 Aug 2009; AllOtherCountries.txt
J.S._ARORA_	[SIK]; ReligiousGroups.txt
J._S._ARORA_	[SIK]; ReligiousGroups.txt
JACK_STRAW_DOUGLAS_ALEXANDER_	[IGOEUREEC 050701-051231] ; president of the CoEU from UNITED_KINGDOM; IGOrulers.txt
JACQUES_DE_LAROSIERE_	[IGOBUSIMF 780617-870115]; IGOrulers.txt
JACQUES_POOS_	[IGOEUREEC 850701-851231][IGOEUREEC 910101-910630][IGOEUREEC 970701-971231] ; president of the CoEU from LUXEMBOURG; IGOrulers.txt
JADE_GOODY_  [GBRELI] ;MleH 10 Jul 2009; AllOtherCountries.txt
JAGJIT_ARORA_	[SIK]; ReligiousGroups.txt
JAGJIT_S ARORA_	[SIK]; ReligiousGroups.txt
JAIME_GAMA_	[IGOEUREEC 000101-000630] ; president of the CoEU from PORTUGAL; IGOrulers.txt
JAMAHIRIYAH_	[LBY] ;MleH 15 Jul 2009; AllOtherCountries.txt
JAMAICA_CONSERVATION_AND_DEVELOPMENT_TRUST_	[NGOJAMENV]; NGO_Actors
JAMESTOWN_FOUNDATION_	[USACVL]; Stuff deleted; AllOtherCountries.txt
JAMES_A._ROBERTS_	[IGOWSTNAT 640101-681231]; IGOrulers.txt
JAMES_WOLFENSOHN_	[IGOUNODEVWBK 950501-050630]; IGOrulers.txt
JAMIA_HAFSA_	[PAKMOS] ;MleH 10 Aug 2009; AllOtherCountries.txt
JAN_ERIK_WILHELMSEN_	[IGOUNO] ;MleH 23 Jul 2009; NGO_Actors
JAPAN PEACE_BOAT_	[NGOJPN] ;MleH 05 Aug 2009; NGO_Actors
JAVIER_DE_CUELLAR_	[IGOUNO 820101-911231] [ELI]; IGOrulers.txt
JAVIER_SOLANA_	[IGOEUREEC 950701-951231][IGOWSTNAT 951205-991006] ; president of the CoEU from SPAIN; IGOrulers.txt
JEAN_FRANCOIS_PONCET_	[IGOEUREEC 790101-790630] ; president of the CoEU from FRANCE; IGOrulers.txt
JEAN_MARIE_GUEHENNO_	[IGOUNO 000101-080801] [---] ;BK 16 Jul 2009; NGO_Actors
JEAN_SAUVAGNARGUES_	[IGOEUREEC 740701-741231] ; president of the CoEU from FRANCE; IGOrulers.txt
JERUSALEM_POST_  [ISRMED] ;MleH 06 Jul 2009; AllOtherCountries.txt
JEWISH_PEACE_FELLOWSHIP_	[NGOJEW]; NGO_Actors
JOAN_B._KROC_INSTITUTE_OF_PEACE_&_JUSTICE_	[NGOCHRCTH]; NGO_Actors
JOAO_DE_DEUS_PINHEIRO_	[IGOEUREEC 920101-920630] ; president of the CoEU from PORTUGAL; IGOrulers.txt
JOHANNESE_SCHAEHINGER_	[IGOEUREEC] ;MleH 24 Jul 2009; NGO_Actors
JOHANNES_WITTEVEEN_	[IGOBUSIMF 730901-780616]; IGOrulers.txt
JOHN_J MCCLOY_	[IGOUNODEVWBK 470301-490630]; IGOrulers.txt
JOHN_MCCLOY_	[IGOUNODEVWBK 470301-490630]; IGOrulers.txt
JONKHEER_VAN_VREDENBURCH_	[IGOWSTNAT 520101-561231] ; deputy secretaries general; IGOrulers.txt
JOSEPH_LUNS_	[IGOEUREEC 600701-601231][IGOEUREEC 630701-631231][IGOEUREEC 690701-691231][IGOWSTNAT 711001-840625] ; president of the CoEU from NETHERLANDS; IGOrulers.txt
JOSEP_PIQUE_I_CAMPS_	[IGOEUREEC 020101-020630] ; president of the CoEU from SPAIN; IGOrulers.txt
JOSE_FRANCISCO_MADEIRA_	[IGOAFRAFU] ;MleH 13 Aug 2009; NGO_Actors
JSTOR_	[NGOUSAEDU]; perhaps MED, since it's an internet publishing NGO?; NGO_Actors
JS_ARORA_	[SIK]; ReligiousGroups.txt
JUBILEE_USA_NETWORK_	[NGOCHRDEV]; NGO_Actors
JUDICIAL_SYSTEM_MONITORING_PROGRAMME_	[NGOTMPHRI]; NGO_Actors
JULIA_CARSON_	[USALEG] ;MleH 11 Aug 2009; AllOtherCountries.txt
J_S_ARORA_	[SIK]; ReligiousGroups.txt
K.U.	[USAEDU] ;MleH 08 Jul 2009 08 Jul 2009; AllOtherCountries.txt
KALOLENI_	[KEN] ;MleH 13 Aug 2009; AllOtherCountries.txt
KAWANUA_USA_	[NGOIDN]; NGO_Actors
KENYA_HUMAN_RIGHTS_COMMISSION_	[KENHRI]; AllOtherCountries.txt
KILIFI_	[KEN] ;MleH 13 Aug 2009; AllOtherCountries.txt
KIMBERLY_CLARK_CORP_	[USABUS] ;MleH 08 Jul 2009; AllOtherCountries.txt
KIRK_KERKORIAN_	[USABUS]; AllOtherCountries.txt
KLAUS_KINKEL_	[IGOEUREEC 940701-941231] ; president of the CoEU from GERMANY; IGOrulers.txt
KNUD_BORGE_ANDERSEN_	[IGOEUREEC 780101-780630] ; president of the CoEU from DENMARK; IGOrulers.txt
KOFI_ANNAN_	[IGOUNO 970101-061231] [ELI]; IGOrulers.txt
KURDISH_HUMAN_RIGHTS_PROJECT_	[NGOKURHRI]; NGO_Actors
KYRGYZ_COMMITTEE_FOR_HUMAN_RIGHTS_	[NGOKGZHRI]; NGO_Actors
LAL_MASJID_	[PAKMOS] ;MleH 10 Aug 2009; AllOtherCountries.txt
LAMBERTO_DINI, THEN ROMANO PRODI_	[IGOEUREEC 960101-960630] ; president of the CoEU from ITALY; IGOrulers.txt
LAO NEW_GENERATION_DEMOCRACY_MOVEMENT_	[NGOLAOHRI]; NGO_Actors
LAO_HUMAN_RIGHTS_COUNCIL_	[NGOLAOHRI]; NGO_Actors
LATIN_AMERICAN_FEDERATION_OF_ASSOCIATIONS_FOR_RELATIVES_OF_THE_DETAINED_DISAPPEARED_	[NGOLAMHRI]; NGO_Actors
LAWYER'S_COMMITTEE_FOR_HUMAN_RIGHTS_	[NGOUSAHRI]; Old name for Human Rights First; NGO_Actors
LAWYERS'_COMMITTEE_FOR_HUMAN_RIGHTS_	[NGOUSAHRI]; Old name for Human Rights First; NGO_Actors
LAWYERS_COMMITTEE_FOR_HUMAN_RIGHTS_	[NGOUSAHRI]; Old name for Human Rights First; NGO_Actors
LEAGUE_OF_WOMEN_VOTERS_	[NGOUSA]; NGO_Actors
LELIO_BASSO_INTERNATIONAL_FOUNDATION_	[NGOITAHRI]; NGO_Actors
LENA_SUNDH_	[IGOUNO] ;MleH 22 Jul 2009 — this could definitely use a timestamp; NGO_Actors
LEO_TINDEMANS_	[IGOEUREEC 820101-820630][IGOEUREEC 870101-870630] ; president of the CoEU from BELGIUM; IGOrulers.txt
LEWIS_PRESTON_	[IGOUNODEVWBK 910901-950531]; IGOrulers.txt
LEWIS_T._PRESTON_	[IGOUNODEVWBK 910901-950531]; IGOrulers.txt
LEWIS_T_PRESTON_	[IGOUNODEVWBK 910901-950531]; IGOrulers.txt
LIFEBRIDGE_FOUNDATION_	[NGOUSA]; NGO_Actors
LIGA_DE_DEFENSA_DEL_MEDIO_AMBIENTE_	[NGOBOLENV]; NGO_Actors
LIONS_CLUB_INTERNATIONAL_	[NGO]; NGO_Actors
LIU_YING_CHUAN_	[USAMED] ;MleH 04 Aug 2009; AllOtherCountries.txt
LORD_CARRINGTON_	[IGOWSTNAT 840625-880701]; IGOrulers.txt
LORD_ROBERTSON_OF_PORT_ELLEN_	[IGOWSTNAT 991014-031217]; IGOrulers.txt
LOUISE_ARBOUR_	[IGOUNOHRIHCH] ;MleH 21 Jul 2009; NGO_Actors
LUKE_SOCIETY_	[NGOCHRHLH]; NGO_Actors
LUZON_STRAIT_	[SEA] ;MleH 03 Aug 2009; AllOtherCountries.txt
LYONPO_CHENKYAB_DORJI_	[IGOSASSAA] ;MleH 22 Jul 2009; NGO_Actors
MACAO_	[MAC] ;CTA 30 Jul 2009; AllOtherCountries.txt
MAGNUS_HIRSCHFELD_CENTRE_FOR_HUMAN_RIGHTS_	[NGOHRI]; NGO_Actors
MAHENDER_MURLIDHAR_SABHNANI_	[USACRM] ;MleH 11 Aug 2009; AllOtherCountries.txt
MAINE_ADOPTION_PLACEMENT_SERVICE_	[NGOUSA]; NGO_Actors
MALAWI_HANDCART_PROJECT_	[NGOMWIDEV]; NGO_Actors
MANAGEMENT_SCIENCES_FOR_HEALTH_	[NGOHLH]; NGO_Actors
MANFRED_NOWAK_	[IGOUNOHRI] ;MleH 24 Jul 2009; NGO_Actors
MANFRED_WÖRNER_	[IGOWSTNAT 880701-940813]; IGOrulers.txt
MANLIO_BROSIO_	[IGOWSTNAT 640801-711001]; IGOrulers.txt
MANOMET_CENTER_FOR_CONSERVATION_SCIENCES_	[USAENV]; Environmental, sustainable dev; AllOtherCountries.txt
MAORE_	[FRA] ;MleH 13 Aug 2009; AllOtherCountries.txt
MAP_INTERNATIONAL_	[NGOCHRHLH]; NGO_Actors
MARCELLO_GUIDI_	[IGOWSTNAT 850101-891231]; IGOrulers.txt
MARCH_OF_DIMES_BIRTH_DEFECTS_FOUNDATION_	[NGOHLH]; NGO_Actors
MARIANO_RUMOR_	[IGOEUREEC 750701-751231] ; president of the CoEU from ITALY; IGOrulers.txt
MARIE_STOPES_INTERNATIONAL_	[NGOHLH]; British, most clinics in Bangladesh; NGO_Actors
MARK_TULLY_	[GBRMEDSEA]; AllOtherCountries.txt
MARY_WERNTZ_	[NGOHLHIRC] ;MleH 22 Jul 2009; NGO_Actors
MATTHEW_KAHANE_	[IGOUNO] ;MleH 22 Jul 2009; NGO_Actors
MAURICE_COUVE_DE_MURVILLE_	[IGOEUREEC 590101-590630][IGOEUREEC 620101-620630][IGOEUREEC 650101-650630][IGOEUREEC 680101-680630] ; president of the CoEU from FRANCE; IGOrulers.txt
MAURICE_SCHUMANN_	[IGOEUREEC 710101-710630] ; president of the CoEU from FRANCE; IGOrulers.txt
MAX_VAN_DER_STOEL_	[IGOEUREEC 760701-761231] ; president of the CoEU from NETHERLANDS; IGOrulers.txt
MCGILL_	[CANEDU] ;MleH 08 Jul 2009; AllOtherCountries.txt
MEDECINS_SANS_FRONTIERES_	[NGOHLHMSF]; NGO_Actors
MEDICAL_BOOKS_FOR_CHINA_INTERNATIONAL_	[NGOCHNHLH]; NGO_Actors
MEDISEND_	[NGOHLH]; NGO_Actors
MEDITERRANEAN_INFORMATION_OFFICE_FOR_ENVIRONMENT,_CULTURE,_AND_SUSTAINABLE_DEVELOPMENT_	[NGOMDTENV]; NGO_Actors
MEKONG_RIVER_COMMISSION_	[IGOSEA] ;MleH 09 Aug 2009; NGO_Actors
MEMBER_NATION_	[UIS] ;MleH 08 Jul 2009; AllOtherCountries.txt
MELANESIA_ [SEA] ;vanb 1 MAR 2010 Promoted from Agent to Actor
MENTAL_DISABILITY_RIGHTS_INTERNATIONAL_	[NGOHRI]; NGO_Actors
MEP_	[IGOEURECC] ;ELH 16 Jul 2009; NGO_Actors
MERCY_SHIPS_	[NGOAFRHLH]; NGO_Actors
MICHAEL_O'KENNEDY_	[IGOEUREEC 790701-791231] ; president of the CoEU from IRELAND; IGOrulers.txt
MICHELE_MONTAS_	[HTIOPPMED <061231] [IGOUNOMED]	[---] ;MleH 06 Jul 2009; NGO_Actors
MICHEL_CAMDESSUS_	[IGOBUSIMF 870116-000214]; IGOrulers.txt
MIDDLE_EAST_CHILDREN'S_ALLIANCE_	[NGOMEA]; NGO_Actors
MINBYUN___LAWYERS_FOR_A_DEMOCRATIC_SOCIETY_	[NGOKORDEV]; NGO_Actors
MINNESOTA_ADVOCATES_FOR_HUMAN_RIGHTS_	[NGOUSAHRI]; NGO_Actors
MINORITY_RIGHTS_GROUP_	[NGOHRI]; NGO_Actors
MOBILITY_INTERNATIONAL_USA_	[NGOHRI]; disabled rights; NGO_Actors
MONETARY_AND_ECONOMIC_COMMUNITY_OF_CENTRAL_AFRICA_	[IGOCAFCEM]; NGO_Actors
MONTREAL SOCIAL_JUSTICE_COMMITTEE_	[NGOCANHRI]; jerry-rigged; NGO_Actors
MONUC INDIAN_CONTINGENT_	[IGOUNO] ;MleH 10 Aug 2009; NGO_Actors
MONUC_	[IGOUNO] ;MleH 10 Aug 2009; NGO_Actors
MOSCOW_SCHOOL_OF_HUMAN_RIGHTS_	[NGORUSHRI]; NGO_Actors
MSF_	[NGOHLHMSF]; NGO_Actors
MS_NEPAL_	[NGONPLDEV]; NGO_Actors
NABILA_A._GOLDI_MZALI_	[IGOMEAARL] ;MleH 13 Aug 2009; NGO_Actors
NATIONAL_CAMPAIGN_ON_DALIT_HUMAN_RIGHTS_	[NGOSASHRI]; NGO_Actors
NATIONAL_CENTER_FOR_NONPROFIT_BOARDS_	[NGOUSABUS]; Now known as BoardSource; specializes in nonprofit advice; NGO_Actors
NATIONAL_COALITION_FOR_HAITIAN_RIGHTS_	[NGOHTIHRI]; NGO_Actors
NATIONAL_COALITION_OF_ANTI_DEPORTATION_CAMPAIGNS_	[NGOGBRREF]; NGO_Actors
NATIONAL_COOPERATIVE_BUSINESS_ASSOCIATION_	[NGOUSABUS]; Co-ops and Associations of Co-ops; NGO_Actors
NATIONAL_COUNCILS_FOR_SUSTAINABLE_DEVELOPMENT_	[NGOENV]; NGO_Actors
NATIONAL_COUNCIL_FOR_LIBERTIES_IN_TUNISIA_	[NGOTUNHRI]; NGO_Actors
NATIONAL_COUNCIL_OF_NEGRO_WOMEN_	[USACVL]; AllOtherCountries.txt
NATIONAL_COUNCIL_OF_WOMEN_OF_CANADA_	[CANCVL]; AllOtherCountries.txt
NATIONAL_DEMOCRATIC_INSTITUTE_FOR_INTERNATIONAL_AFFAIRS_	[USACVL]; Affiliated with Democratic Party, potentially change to PTY; AllOtherCountries.txt
NATIONAL_GROUND_WATER_ASSOCIATION_	[NGOUSAENV]; NGO_Actors
NATIONAL_HOUSING_CONFERENCE_	[USACVL]; Housing Issues in the US; AllOtherCountries.txt
NATIONAL_JEWISH_COMMUNITY_RELATIONS_ADVISORY_	[USAJEW]; Now known as Jewish Council for Public Affairs; AllOtherCountries.txt
NATIONAL_LAWYERS_GUILD_	[USAJUD]; AllOtherCountries.txt
NATIONAL_NETWORK_FOR_IMMIGRANT_AND_REFUGEE_RIGHTS_	[NGOUSAREF]; NGO_Actors
NATIONAL_ORGANIZATION_FOR_WOMEN_	[USAHRI]; AllOtherCountries.txt
NATIONAL_SOCIETY_FOR_HUMAN_RIGHTS_	[SAUHRI]; AllOtherCountries.txt
NATIONAL_WILDLIFE_FEDERATION_	[USAENV]; AllOtherCountries.txt
NATO_	[IGOWSTNAT]; North Atlantic Treaty Org.; NGO_Actors
NATURAL_RESOURCES_DEFENSE_COUNCIL_	[NGOUSAENV]; NGO_Actors
NAW_SAY_PHAW_	[NGOMMRMED] ;MleH 04 Aug 2009; NGO_Actors
NEPAL GURKHA_SOLDIERS_	[GBRMIL] ;MleH 23 Jul 2009; AllOtherCountries.txt
NEREO_PRESERVADOR_DEL_MEDI_AMBIENTE_	[NGOEURDEV]; NGO_Actors
NETAID_	[NGODEV]; anti-poverty concerns; NGO_Actors
NETHERLANDS_INTERDISCIPLINARY_DEMOGRAPHIC_INSTITUTE_	[NLDEDU]; AllOtherCountries.txt
NETWORK_FOR_EDUCATION_AND_ACADEMIC_RIGHTS_	[NGOGBRHRI]; NGO_Actors
NETWORK_OF_EAST_WEST_WOMEN_POLAND_	[NGOPOL]; NGO_Actors
NETWORK_OF_EAST_WEST_WOMEN_POLSKA_	[NGOPOL]; NGO_Actors
NETWORK_OF_FOUNDATIONS_AND_NONPROFIT_ORGANIZATIONS_	[NGO]; NGO_Actors
NETWORK_WOMEN_IN_DEVELOPMENT_EUROPE_	[NGOEURDEV]; NGO_Actors
NEW_ECONOMIC_PARTNERSHIP_FOR_AFRICA'S_DEVELOPMENT_	[IGOAFRDEVNEP]; NGO_Actors
NEW_TANG_DYNASTY_	[USAMED] ;MleH 04 Aug 2009; AllOtherCountries.txt
NGO_	[NGO] ;MleH 24 Jul 2009; NGO_Actors
NGO_NET_	[NGOAFRMED]; NGO_Actors
NGO_NETWORK_ON_THE_QUESTION_OF_PALESTINE_	[NGOPAL]; NGO_Actors
NICHOLAS_COSTELLO_	[IGOEUREEC] ;MleH 12 Aug 2009; NGO_Actors
NIGER_DELTA_	[NGA] ;ELH 17 Jul 2009; AllOtherCountries.txt
NON_GOVERNMENTAL_ORGANISATION_	[NGO] ;MleH 06 Aug 2009; NGO_Actors
NON_GOVERNMENTAL_ORGANIZATION_	[NGO] ;MleH 06 Aug 2009; NGO_Actors
NON_GOVERNMENT_ORGANISATION_	[NGO] ;ELH 09 Jul 2009; NGO_Actors
NON_GOVERNMENT_ORGANIZATION_	[NGO] ;ELH 09 Jul 2009; NGO_Actors
NORBERT_SCHMELZER_	[IGOEUREEC 720701-721231] ; president of the CoEU from NETHERLANDS; IGOrulers.txt
NORMAN_BORLAUG_	[USAEDUAGR] ;MleH 10 Aug 2009; AllOtherCountries.txt
NORTHERN_IRELAND_HUMAN_RIGHTS_COMMISSION_	[NGOGBRHRI]; NGO_Actors
NORTH_AMERICA_	[NMR] ;MleH 10 Aug 2009; AllOtherCountries.txt
NORTH_ATLANTIC_TREATY_ORGANIZATION_	[IGOWSTNAT]; NGO_Actors
NORWEGIAN_REFUGEE_COUNCIL_	[NGONORREF]; NGO_Actors
NUCLEAR_AGE_PEACE_FOUNDATION_	[NGOUSA]; NGO_Actors
NUCLEAR_SUPPLIERS_GROUP_	[IGOBUS] ;MleH 12 Aug 2009; NGO_Actors
NUCLEAR_THREAT_INITIATIVE_	[NGOUSA]; NGO_Actors
NUEVOS_DERECHOS_DEL_HOMBRE_	[NGOARGHRI]; NGO_Actors
OAPEC_	[IGOARBBUSAPE]; Org of Arab Petroleum Exporting Countries; NGO_Actors
OAU_	[IGOAFROAU]; Organization of African Unity; NGO_Actors
OFID_	[IGOBUSOPCDEV] ;MleH 23 Jul 2009; NGO_Actors
OHCHR_	[IGOUNOHRIHCH] ;MleH 21 Jul 2009; NGO_Actors
OHCHR_NEPAL_	[IGOUNOHRIHCH] ;MleH 23 Jul 2009; NGO_Actors
OIC_	[IGOMOSOIC]; ORGANIZATION OF ISLAMIC CONFERENCES; NGO_Actors
OLIVE_(ORGANISATION_DEVELOPMENT_AND_TRAINING)	[NGOZAFDEV]; NGO_Actors
ONEWORLD.NET_	[NGOENV]; NGO_Actors
ONG_KENG_YONG_	[IGOSEAASN] ;MleH 05 Aug 2009; NGO_Actors
OPEC_	[IGOBUSOPC]; ORGANIZATION OF PETROLEUM EXPORTING COUNTRIES; NGO_Actors
OPERATION_SMILE_	[NGOUSAHLH]; NGO_Actors
OPIA_MENSAH_KUMAH_	[IGOUNODEV] ;MleH 13 Aug 2009; NGO_Actors
ORGANISATION_OF_THE_ISLAMIC_CONFERENCE_	[IGOMOS]; NGO_Actors
ORGANISATION_OF_WOMEN'S_FREEDOM_IN_IRAQ_	[NGOIRQHRI]; NGO_Actors
ORGANIZATION_FOR_DEFENDING_VICTIMS_OF_VIOLENCE_	[NGOIRNHRI]; NGO_Actors
ORGANIZATION_OF_AFRICAN_UNITY_	[IGOAFROAU]; NGO_Actors
ORGANIZATION_OF_AMERICAN_STATES_	[IGOOAS]; NGO_Actors
ORGANIZATION_OF_ISLAMIC_CONFERENCES_	[IGOMOSOIC]; NGO_Actors
ORGANIZATION_OF_NON_ALIGNED_COUNTRIES_	[IGONON]; NGO_Actors
ORGANIZATION_OF_PETROLEUM_EXPORTING_COUNTRIES_	[IGOOPC]; NGO_Actors
ORGANIZATION_OF_THE_ISLAMIC_CONFERENCE_	[IGOMOS]; NGO_Actors
OSCE_	[IGOEURSCE]; Council of Security & Cooperation in Europe; NGO_Actors
OSMAN_OLCAY	_TURKEY_	[IGOWSTNAT 690101-711231]; IGOrulers.txt
OTTAWA HUMAN_RIGHTS_INTERNET_	[NGOHRI]; a little bit jerry-rigged; NGO_Actors
OVERSEAS_DEVELOPMENT_INSTITUTE_	[NGODEV]; NGO_Actors
OXFAM_	[NGOXFM]; perhaps insert DEV?; NGO_Actors
PACIFIC_INSTITUTE_FOR_WOMEN'S_HEALTH_	[NGOHLH]; NGO_Actors
PAKISTAN_RANGER_	[PAKCOP] ;MleH 11 Aug 2009; AllOtherCountries.txt
PALESTINIAN_CENTRE_FOR_HUMAN_RIGHTS_	[NGOPALHRI]; NGO_Actors
PALESTINIAN_HUMAN_RIGHTS_MONITORING_GROUP_	[NGOPALHRI]; NGO_Actors
PALESTINIAN_LIBERATION_ORGANIZATION_	[PALPLO] ;ELH 04 Aug 2009; AllOtherCountries.txt
PALK_STRAIT_	[SAS] ;MleH 28 Jul 2009; AllOtherCountries.txt
PANAMERICAN/PANAFRICAN_ASSOCIATION_	[NGO]; NGO_Actors
PANEL_ON_TAKEOVERS_AND_MERGERS_	[NGOGBRBUS] ;MleH 10 Jul 2009; NGO_Actors
PANOS_INSTITUTE_	[NGOMED]; NGO_Actors
PAN_AFRICAN_PARLIAMENT_	[IGOAFRPAP]; NGO_Actors
PAN_AMERICAN_HEALTH_AND_EDUCATION_FOUNDATION_	[NGOSAMHLH]; Health concerns in the Americas; NGO_Actors
PAN_PACIFIC_AND_SOUTHEAST_ASIA_WOMEN'S_ASSOCIATION_INTERNATIONAL_	[NGOSEA]; NGO_Actors
PAOLO_PANSA_CEDRONIO_	[IGOWSTNAT 710101-781231]; IGOrulers.txt
PARIS_CLUB_	[IGOBUSPRC]; NGO_Actors
PARTNERS_FOR_DEMOCRATIC_CHANGE_	[NGODEV]; Group of NGOs Specializing in Europe, Americas, and MidEast; NGO_Actors
PASCAL_LAMY_	[IGOBUSWTO] ;MleH 09 Jul 2009; NGO_Actors
PAUL_HENRI_SPAAK_	[IGOEUREEC 610101-610630] ; president of the CoEU from BELGIUM; IGOrulers.txt
PAUL_KLEBNIKOV_	[USAMEDRUSCNY]; AllOtherCountries.txt
PAUL_WOLFOWITZ_	[IGOUNODEVWBK 050601-070630]; IGOrulers.txt
PBI_GUATEMALA_	[NGOGTMHRI]; NGO_Actors
PEACE_BRIGADES_INTERNATIONAL_	[NGOHRI]; NGO_Actors
PENELOPE_WILLIS_	[GBRMEDLKATAM]; AllOtherCountries.txt
PEN_AMERICA_	[USAMED]; AllOtherCountries.txt
PEOPLE'S_UNION_FOR_CIVIL_LIBERTIES_	[NGOINDHRI]; NGO_Actors
PEOPLES_MOVEMENT_FOR_HUMAN_RIGHTS_LEARNING_	[NGOHRI]; human rights & social justice; NGO_Actors
PEOPLE_&_PLANET_	[GBREDU]; AllOtherCountries.txt
PERSIAN_GULF_	[PGS]; AllOtherCountries.txt
PERUVIAN_INSTITUTE_FOR_EDUCATION_IN_HUMAN_RIGHTS_AND_PEACE_	[NGOPERHRI]; NGO_Actors
PER_JACOBSSON_	[IGOBUSIMF 561121-630505]; IGOrulers.txt
PETER_BARRY_	[IGOEUREEC 840701-841231] ; president of the CoEU from IRELAND; IGOrulers.txt
PETER_CARRINGTON_	[IGOEUREEC 810701-811231] ; president of the CoEU from UNITED_KINGDOM; IGOrulers.txt
PETER_CORDINGLEY_	[IGOUNOHLHWHOMED] ;MleH 08 Aug 2009; NGO_Actors
PETER_MUNYA_	[KENGOVCOP] ;MleH 13 Aug 2009; AllOtherCountries.txt
PHELIM_KYNE_	[NGOHRIHRW] ;MleH 06 Aug 2009; NGO_Actors
PHILIP_ALSTON_	[IGOUNO] ;ELH 09 Jul 2009; NGO_Actors
PHYSICIANS_FOR_GLOBAL_SURVIVAL_	[NGOCAN]; AllOtherCountries.txt
PHYSICIANS_FOR_HUMAN_RIGHTS_	[NGOHRIHLH]; NGO_Actors
PHYSICIANS_FOR_HUMAN_RIGHTS_ISRAEL_	[NGOISRHRIHLH]; NGO_Actors
PHYSICIANS_FOR_HUMAN_RIGHTS_UNITED_KINGDOM_	[NGOGBRHRIHLH]; NGO_Actors
PHYSICIANS_FOR_SOCIAL_RESPONSIBILITY_	[NGO]; NGO_Actors
PIERRE_GREGOIRE_	[IGOEUREEC 690101-690630] ; president of the CoEU from LUXEMBOURG; IGOrulers.txt
PIERRE_HARMEL_	[IGOEUREEC 700101-700630][IGOEUREEC 730101-730630] ; president of the CoEU from BELGIUM; IGOrulers.txt
PIERRE_PAUL_SCHWEITZER_	[IGOBUSIMF 630901-730831]; IGOrulers.txt
PLAN_USA_	[NGODEV]; NGO_Actors
POLARIS_PROJECT_	[NGOHRI]; NGO_Actors
POLISH_AMERICAN_CONGRESS_	[USACVL]; AllOtherCountries.txt
POPE_BENEDICT_	[CHRCTH] ;MleH 10 Jul 2009; ReligiousGroups.txt
POPULATION_ACTION_INTERNATIONAL_	[NGOHLH]; Family Planning etc.; NGO_Actors
POPULATION_COMMUNICATIONS_INTERNATIONAL,_INC._	[NGOMED]; Produces edutainment on health & development issues; NGO_Actors
POPULATION_REFERENCE_BUREAU_	[NGO]; NGO_Actors
POPULATION_SERVICES_INTERNATIONAL_	[NGOHLH]; NGO_Actors
PRACTICAL_POINTERS_FOR_PRIMARY_CARE_	[USAEDU]; Provides abstracts of health care journals; AllOtherCountries.txt
PRESIDENT_OF_SIKH_FORUM_	[SIK]; ReligiousGroups.txt
PRIVACY_INTERNATIONAL_	[NGOGBRHRI]; NGO_Actors
PROFESSIONALS_FROM_CALIFORNIA_	[USABUS] ;CTA 13 Jul 2009; AllOtherCountries.txt
PROJECT_MERCY_	[NGOETHCHRDEV]; originally refugee relief, now basic development; NGO_Actors
PROPOOR_	[NGOSASDEV]; NGO_Actors
PROPOOR:_SOUTH_ASIA_	[NGOSASDEV]; NGO_Actors
PROSHIKA_	[NGODEV]; NGO_Actors
PSCAU_	[IGOAFRAFU] ;MleH 13 Aug 2009; NGO_Actors
PUBLIC_COMMITTEE_AGAINST_TORTURE_IN_ISRAEL_	[NGOISRHRI]; NGO_Actors
PUBLIC_HEALTH_INSTITUTE_	[USAHLH]; Health & Environmental concernss; AllOtherCountries.txt
PUBLIC_LIBRARY_OF_SCIENCE_	[USAEDU]; makes scientific & medical lit available; AllOtherCountries.txt
PUBLIC_SERVICES_INTERNATIONAL_	[NGOLAB]; NGO_Actors
QUAID_E_AZAM_	[PAKEDU] ;MleH 11 Aug 2009; AllOtherCountries.txt
R.K._PACHAURI_	[IGOUNOENV] ;MleH 11 Aug 2009; NGO_Actors
R.R.S._CHAHAL_	[SIK]; ReligiousGroups.txt
R._R._S._CHAHAL_	[SIK]; ReligiousGroups.txt
RABBIS_FOR_HUMAN_RIGHTS_	[NGOJEWHRI]; NGO_Actors
RAINFOREST_ACTION_NETWORK_	[NGOUSAENV]; NGO_Actors
RAINFOREST_ALLIANCE_	[NGOENV]; NGO_Actors
RALPH_FIENNES_	[IGOUNOKID] ;MleH 14 Jul 2009; NGO_Actors
RAM_CHAHAL_	[SIK]; ReligiousGroups.txt
RAM_RAGHBIR CHAHAL_	[SIK]; ReligiousGroups.txt
RAND_CORPORATION_	[NGOUSA]; NGO_Actors
RAND_LABOR_AND_POPULATION_	[NGOUSALAB]; NGO_Actors
RED_CRESCENT_	[NGOHLHIRC]; part of Intl Red Cross & Red Crescent Movement; NGO_Actors
RED_CROSS_	[NGOHLHIRC]; part of Intl Red Cross & Red Crescent Movement; NGO_Actors
REFUGEES_INTERNATIONAL_	[NGOREF]; NGO_Actors
REFUGEE_ADVOCATE_	[NGOHRI] ;MleH 28 Jul 2009; NGO_Actors
REFUGEE_LAW_PROJECT_	[UGAHRIREF]; AllOtherCountries.txt
RENAAT_VAN_ELSLANDE_	[IGOEUREEC 670101-670630] ; president of the CoEU from BELGIUM; IGOrulers.txt
RENE_DUBOS_CENTER_FOR_HUMAN_ENVIRONMENTS,_INC_	[NGOENV]; NGO_Actors
REPORTERS_SANS_FRONTIERES_	[NGOHRI]; NGO_Actors
REPORTERS_WITHOUT_BORDERS_	[NGOHRIMED] ;MleH 04 Aug 2009; NGO_Actors
RESOURCE_AFRICA_	[NGOAFRENV]; NGO_Actors
RESOURCE_INSTITUTE_FOR_LOW_ENTROPY_SYSTEMS_	[NGOENV]; sustainable dev, environmental impact on health; NGO_Actors
REUTERS_	[USAMED] ;MleH 10 Jul 2009; AllOtherCountries.txt
REVOLUTIONARY_ASSOCIATION_OF_THE_WOMEN_OF_AFGHANISTAN_	[NGOAFGDEV]; NGO_Actors
RICHARD_RAGAN_	[IGOUNOWFP] ;MleH 22 Jul 2009; NGO_Actors
RIGHTS_INTERNATIONAL_	[NGOHRI]; NGO_Actors
RINALDO_PETRIGNANI_	[IGOWSTNAT 780101-811231]; IGOrulers.txt
RIOS_VIVOS_	[NGOENV]; NGO_Actors
ROBERT_MCNAMARA_	[IGOUNODEVWBK 680401-810630]; IGOrulers.txt
ROBERT_YOUNG_PELTON_	[CANMED]; AllOtherCountries.txt
ROBERT_ZOELLICK_	[IGOUNODEVWBK >070701]; IGOrulers.txt
RODDY_SCOTT_	[GBRMED]; AllOtherCountries.txt
RODRIGO_RATO_	[IGOBUSIMF 040607-071031]; IGOrulers.txt
ROLAND_DUMAS_	[IGOEUREEC 840101-840630][IGOEUREEC 890701-891231] ; president of the CoEU from FRANCE; IGOrulers.txt
ROMANIA_DEVELOPMENT_GATEWAY_	[NGOROMDEV]; NGO_Actors
ROTARY_CLUB_	[NGO] ;MleH 22 Jul 2009; NGO_Actors
ROTARY_INTERNATIONAL_	[NGO]; NGO_Actors
RRS_CHAHAL_	[SIK]; ReligiousGroups.txt
R_K_PACHAURI_	[IGOUNOENV] ;MleH 11 Aug 2009; NGO_Actors
R_R_S_CHAHAL_	[SIK]; ReligiousGroups.txt
S.S._MAITRA_	[NGOINDHLHIRC]; executive officer of the Indian Red Cross; NGO_Actors
S._S._MAITRA_	[NGOINDHLHIRC]; executive officer of the Indian Red Cross; NGO_Actors
SAARC_	[IGOSASSAA] ;MleH 22 Jul 2009; NGO_Actors
SADC_	[IGOSAFSAD] ;MleH 13 Aug 2009; NGO_Actors
SAFERWORLD_	[IGODEV] ;MleH 10 Aug 2009; NGO_Actors
SAFE_MOTHERHOOD_	[NGOHLH]; NGO_Actors
SAFTA_	[IGOSASBUS] ;MleH 21 Jul 2009; NGO_Actors
SAHEL_SAHARAN_STATES_	[IGOAFRBUS] ;MleH 13 Aug 2009; NGO_Actors
SAMLEE_PLIANBANGCHANG_	[IGOUNOHLHWHO] ;CTA 31 Jul 2009; NGO_Actors
SATINATH_SARANGI_	[NGOIND]; founder of Bhopal Group for Information and Action; NGO_Actors
SAVE_THE_CHILDREN_INTERNATIONAL_	[NGODEV]; NGO_Actors
SAVE_THE_CHILDREN_USA_	[NGOUSADEV]; NGO_Actors
SCHOOL_SISTERS_OF_NOTRE_DAME_	[NGOCHRCTHEDU]; the Catholicism is a guess, and they aren't pure edu; NGO_Actors
SEATO_	[IGOSEABUSSOT]; South East Asian Treaty Organization (security); NGO_Actors
SECRETARIAT_OF_THE_UN_	[IGOUNO]; NGO_Actors
SECRETARIAT_OF_THE_UNITED_NATIONS_	[IGOUNO]; NGO_Actors
SERBIA_	[SCGSRB] ;MleH 06 Aug 2009; AllOtherCountries.txt
SERGIO_BALANZINO_	[IGOWSTNAT 940813-941017][IGOWSTNAT 951020-951205][IGOWSTNAT 940101-011231]; IGOrulers.txt
SHAFI_IMAM_RUMI_	[PAKREBBGD]; from the War of Liberation; AllOtherCountries.txt
SHARIF_SAIDOV_	[TJKGOVBUS] ;MleH 10 Aug 2009; AllOtherCountries.txt
SHIRIN_EBADI_	[IRNHRI] ;MleH 14 Jul 2009; AllOtherCountries.txt
SIACHEN_GLACIER_	[SAS] ;MleH 15 Jul 2009; AllOtherCountries.txt
SIEGFRIED_BALKE_	[IGOEUREEC 580701-581231] ; president of the CoEU from WEST_GERMANY; IGOrulers.txt
SIKH_FORUM_	[SIK]; ReligiousGroups.txt
SINGH_SIDHU_	[SIK]; ReligiousGroups.txt
SIOUX_INDIAN_	[NMR] ;MleH 06 Jul 2009 06 Jul 2009; AllOtherCountries.txt
SISTERHOOD_IS_GLOBAL_INSTITUTE_	[NGO]; NGO_Actors
SISTERS_OF_NOTRE_DAME_DE_NAMUR_	[NGOCHRCTHEDU]; NGO_Actors
SLMM_	[IGOLKA]; Sri Lanka Monitoring Mission; NGO_Actors
SOCIAL_JUSTICE_COMMITTEE MONTREAL_	[NGOCANHRI]; jerry-rigged; NGO_Actors
SOCIAL_WATCH_	[NGODEV]; NGO_Actors
SOCIEDAD_PERUANA_DE_DERECHO_AMBIENTAL_	[NGOPERENV]; NGO_Actors
SOCIETAS_INTERNATIONALIS_LIMNOLOGIAE_THEORETICAE_ET_APPLICATAE_	[NGOENV]; freshwater ecology; NGO_Actors
SOCIETATEA_ECOLOGICA_BIOTICA_	[NGOMDAENV]; NGO_Actors
SOLAR_COOKERS_INTERNATIONAL_	[NGO]; exactly what it sounds like...; NGO_Actors
SOLIDARIDAD_INTERNACIONAL_	[NGODEV]; NGO_Actors
SOUTHEAST_ASIA_	[SEA] ;CTA 10 Jul 2009; AllOtherCountries.txt
SOUTHEAST_ASIAN_COUNTRIES_	[UISSEA] ;MleH 05 Aug 2009; AllOtherCountries.txt
SOUTHEAST_ASIAN_NATIONS_	[IGOSEAASN] ;MleH 05 Aug 2009; NGO_Actors
SOUTHEAST_ASIA_COLLECTIVE_DEFENSE_TREATY_	[IGOSEASOT]; NGO_Actors
SOUTHERN_AFRICAN_DEVELOPMENT_COMMUNITY_	[IGOSAFDEVSAD]; NGO_Actors
SOUTH_AFRICAN_PRISONERS_ORGANISATION_FOR_HUMAN_RIGHTS_	[NGOZAFHRI]; NGO_Actors
SOUTH_AND_MESO_AMERICAN_INDIAN_RIGHTS_CENTER_	[NGOLAMHRI]; NGO_Actors
SOUTH_AND_NORTH_KOREA_	[KOR/PRK] ;MleH 17 Jul 2009; AllOtherCountries.txt
SOUTH_ASIA_	[SAS]; AllOtherCountries.txt
SOUTH_ASIAN_ASSOCIATION_  [IGOSASSAA] ;MleH 15 Jul 2009; NGO_Actors
SOUTH_ASIAN_FREE_TRADE_AREA_	[IGOSASBUS] ;MleH 21 Jul 2009; NGO_Actors
SOUTH_ASIAN_HUMAN_RIGHTS_DOCUMENTATION_CENTRE_	[NGOSASHRI]; NGO_Actors
SOUTH_ASIA_MEDIA_MONITOR_	[NGOSASMED] ;MleH 20 Jul 2009; NGO_Actors
SOUTH_EAST_ASIA_	[SEA] ;MleH 07 Jul 2009; AllOtherCountries.txt
SOVEREIGNTY_INTERNATIONAL_	[NGOENV]; NGO_Actors
SPANISH_COMMISSION_FOR_REFUGEE_ASSISTANCE_	[NGOESPREF]; NGO_Actors
SPECIAL_RAPPORTEUR_OF_THE_UNITED_NATIONS_HUMAN_RIGHTS_COUNCIL_	[IGOUNO] ;ELH 09 Jul 2009; NGO_Actors
SPECIAL_REPRESENTATIVE_FOR_CHILDREN AND CONFLICT SRI_LANKA_	[IGOUNOLKAHRI] ;MleH 28 Jul 2009; NGO_Actors
SPOKESMAN_JAEGER_	[DEUGOVMED] ;MleH 06 Aug 2009; AllOtherCountries.txt
SRI_LANKA_MONITORING_MISSION_	[IGOLKA]; NGO_Actors
SS_MAITRA_	[NGOINDHLHIRC]; executive officer of the Indian Red Cross; NGO_Actors
STAKEHOLDER_FORUM_FOR FUTURE_	[NGOENV]; also development; NGO_Actors
STATEWATCH_	[NGOEURMED]; NGO_Actors
STEFAN_FROWEIN_	[IGOEUREEC] ;MleH 24 Jul 2009; NGO_Actors
STEPHEN_DOUGLAS_TOM_	[USAMIL] ;ELH 09 Jul 2009; AllOtherCountries.txt
STIFTUNG_EUROPAISCHES_NATURERBE_	[NGODEUENV]; NGO_Actors
SUDAN_HUMAN_RIGHTS_ASSOCIATION_	[NGOSDNHRI]; NGO_Actors
SUDAN_HUMAN_RIGHTS_ORGANIZATION_	[NGOSDNHRI]; NGO_Actors
SUDAN_ORGANIZATION_AGAINST_TORTURE_	[NGOSDNHRI]; NGO_Actors
SUNS_SOUTH_NORTH_DEVELOPMENT_MONITOR_	[NGOMEDDEV]; NGO_Actors
SUPREME_COURT_CHIEF_JUSTICE_REYNATO_PUNO_	[USAJUD] ;ELH 16 Jul 2009; AllOtherCountries.txt
SURVIVAL_INTERNATIONAL_	[NGOEURHRI]; all offices are in Europe, though deals with tribal peoples; NGO_Actors
SUSTAINABLE_DEVELOPMENT_INFORMATION_SERVICE_	[NGOENV]; provision of info on environmental issues; NGO_Actors
SWEATSHOP_WATCH_	[NGOUSALAB]; NGO_Actors
S_SARANGI_	[NGOIND]; founder of Bhopal Group for Information and Action; NGO_Actors
S_S_MAITRA_	[NGOINDHLHIRC]; executive officer of the Indian Red Cross; NGO_Actors
T4CD_	[NGOENV]; NGO_Actors
TACDB_	[NGOMMRHRI] ;MleH 05 Aug 2009; NGO_Actors
TAIGA_RESCUE_NETWORK_	[NGOEURENV]; NGO_Actors
TAIWAN_ASSOCIATION_FOR_HUMAN_RIGHTS_	[NGOTWNHRI]; NGO_Actors
TALIBAN_	[AFGINSTAL >011112] ;MleH 14 Jul 2009 + ELH 24 Jul 2009; AllOtherCountries.txt
TAMILNET_	[NGOLKATAMMED]; NGO_Actors
TAMIL_HUMAN_RIGHTS_CENTRE_	[NGOTAMHRI] ;MleH 28 Jul 2009; NGO_Actors
TANTIWITTAYAPITAK_	[NGOHRIAMN] ;MleH 06 Aug 2009; NGO_Actors
TAPOL_BULLETIN_	[NGOIDNHRI]; NGO_Actors
TARAI_	[TER] ;MleH 10 Aug 2009; AllOtherCountries.txt
TASMANIAN_GAY_AND_LESBIAN_RIGHTS_GROUP_	[NGOAUSHRI]; NGO_Actors
TATA_ENERGY_RESEARCH_INSTITUTE_	[NGOENV]; NGO_Actors
TECHNICAL_CENTRE_FOR_AGRICULTURAL_AND_RURAL_COOPERATION_	[NGODEVAGR]; NGO_Actors
TECHNOLOGIES_FOR_CONSERVATION_AND_DEVELOPMENT_	[NGOENV]; NGO_Actors
TERAI_	[TER] ;MleH 21 Jul 2009; AllOtherCountries.txt
THAN_DOKE_	[NGOMMRLAB] ;MleH 05 Aug 2009; NGO_Actors
THEODOROS_PANGALOS_	[IGOEUREEC 880701-881231] ; president of the CoEU from GREECE; IGOrulers.txt
THE_ASSOCIATED_PRESS_	[USAMED] ;MleH 09 Jul 2009 09 Jul 2009; AllOtherCountries.txt
THE_AU_	[IGOAFRAFU] ;MleH 13 Aug 2009; NGO_Actors
THE_CARTER_CENTER_	[NGOUSA]; Waging Peace, Fighting Disease, Buidling Hope; NGO_Actors
THE_COUSTEAU_SOCIETY_	[NGOENV]; NGO_Actors
THE_EUROPEAN_UNION_	[IGOEUREEC] ;MleH 12 Jul 2009; NGO_Actors
THE_EU_	[IGOEUREEC] ;MleH 09 Jul 2009; NGO_Actors
THE_FOREST_MANAGEMENT_TRUST_	[NGOENV]; NGO_Actors
THE_FOUNDATION_FOR_DEMOCRACY_IN_AFRICA_	[NGOAFRDEV]; development, democracy, sustainable dev. & economic growth; NGO_Actors
THE_HUMAN_RIGHTS_EDUCATION_INSTITUTION_	[NGOMMRHRI]; NGO_Actors
THE_HUNGER_PROJECT_	[NGODEV]; NGO_Actors
THE_INTERNATIONAL_COMMUNITY_	[UIS] ;MleH 17 Jul 2009; AllOtherCountries.txt
THE_POPE_	[CHRCTH] ;ELH 09 Jul 2009, ed. MleH; ReligiousGroups.txt
THE_SECURITY_COUNCIL_	[IGOUNO] ;MleH 04 Aug 2009; NGO_Actors
THE_TEMPLE_OF_UNDERSTANDING_	[NGOREL]; inter-faith org for religious pluralism; NGO_Actors
THE_TRUST_FOR_THE_AMERICAS_	[NGO]; specifically supports the OAS, coding?; NGO_Actors
THE_UN_	[IGOUNO] ;MleH 20 Jul 2009; NGO_Actors
THE_WB_	[IGOUNOWBK] ;MleH 09 Aug 2009; NGO_Actors
THE_WEST_AFRICAN_COUNTRY_	[UISWAF]; AllOtherCountries.txt
THIERRY_BORJE_DE_MOZOTA_	[FRAGOVMIL] ;MleH 11 Aug 2009; AllOtherCountries.txt
THIRD_WORLD_NETWORK_	[NGODEV]; NGO_Actors
THRC_	[NGOTAMHRI] ;MleH 28 Jul 2009; NGO_Actors
TOBIN_TAX_INITIATIVE_	[NGOBUS]; USA & UK for excise taxes on currency transactions; NGO_Actors
TONGA_ONLINE_	[NGOTONMED]; Provision of online presence for Tongo; NGO_Actors
TORTURE_ABOLITION_AND_SURVIVORS_SUPPORT_COALITION_INTERNATIONAL_	[NGOHRI]; NGO_Actors
TRANSPARENCY_INTERNATIONAL_	[NGODEV]; corruption issues; NGO_Actors
TROPENBOS_INTERNATIONAL_	[NGOENV]; NGO_Actors
TRYGVE_LIE_	[IGOUNO 460201-521110] [ELI]; IGOrulers.txt
U.N.	[IGOUNO] ;MleH 06 Aug 2009 + BK 16 Jul 2009; NGO_Actors
U.N._MONITOR_	[IGOUNO] ;MleH 20 Jul 2009; NGO_Actors
U.S._AFRICA_LEADERSHIP_INSTITUTE_	[NGOAFRDEV]; civil society in US & Africa; NGO_Actors
U.S._CAMPAIGN_FOR_BURMA_	[NGOMMRHRI] ;MleH 05 Aug 2009; NGO_Actors
U.S._COMMITTEE_FOR_REFUGEES_	[NGOUSAREF]; NGO_Actors
U.S._TROOPS_	[USAMIL] ;ELH 06 Jul 2009; AllOtherCountries.txt
UEMOA_	[IGOWAFBUSUEM]; Economic & Monetary Union of West Africa; NGO_Actors
UFFE_ELLEMANN_JENSEN_	[IGOEUREEC 820701-821231][IGOEUREEC 870701-871231] ; president of the CoEU from DENMARK; IGOrulers.txt
UGANDA_NGO_DIRECTORY_	[NGOUGA]; NGO_Actors
UN DEPARTMENT_OF_PEACEKEEPING_OPERATIONS_	[IGOUNO] ;BK 07 Jul 2009; NGO_Actors
UNDP_	[IGOUNODEV] ;MleH 13 Aug 2009 + BK 13 Jul 2009; NGO_Actors
UNED_FORUM_	[NGOENV]; NGO_Actors
UNESCAP_	[IGOUNODEV] ;CTA 31 Jul 2009; NGO_Actors
UNHCR_	[IGOUNOREFHCR]; UN High Commission on Human Rights; NGO_Actors
UNICEF_	[IGOUNOKID]; UN Children's Fund; NGO_Actors
UNIFEM_	[IGOUNODEV]; women's promotion; NGO_Actors
UNION_NATIONALE_DE_LA_FEMME_TUNISIENNE_	[NGOTUNDEV]; wide-range women's group; NGO_Actors
UNITED_CHURCH_BOARD_FOR_WORLD_MINISTRIES_	[NGOCHR]; NGO_Actors
UNITED_NATIONS_	[IGOUNO]; NGO_Actors
UNITED_NATIONS_CHILDREN'S_FUND_	[IGOUNOKID]; NGO_Actors
UNITED_NATIONS_COMMISSION_FOR_HUMAN_RIGHTS_	[IGOUNOHRIHCH]; NGO_Actors
UNITED_NATIONS_COMMISSION_FOR_REFUGEES_	[IGOUNOREFHCR]; NGO_Actors
UNITED_NATIONS_DEVELOPMENT_FUND_FOR_WOMEN_	[IGOUNODEV]; NGO_Actors
UNITED_NATIONS_FOOD_AND_AGRICULTURE_ORGANIZATION_	[IGOUNOAGRFAO]; NGO_Actors
UNITED_NATIONS_MONITOR_	[IGOUNO] ;MleH 20 Jul 2009; NGO_Actors
UNITED_NATIONS_SECRETARIAT_	[IGOUNO]; NGO_Actors
UNITED_STATES_BOOK_EXCHANGE_	[NGOEDU]; provides back issues of scholarly journals; NGO_Actors
UNITED_STATES_COMMITTEE_FOR_UNIFEM_	[NGOUSA]; NGO_Actors
UNITED_STATES_FUND_FOR_UNICEF_	[NGOUSAHLH]; NGO_Actors
UNITED_WAY_INTERNATIONAL_	[NGO]; NGO_Actors
UNIT_FOR_SUSTAINABLE_DEVELOPMENT_AND_ENVIRONMENT_	[NGOENV]; NGO_Actors
UNMIN_	[IGOUNO] ;MleH 21 Jul 2009; NGO_Actors
UNOG:_NGO_DATABASE_	[NGO]; NGO_Actors
UNREPRESENTED_NATIONS_AND_PEOPLES_ORGANISATION_	[NGO]; could we add a SEP?; NGO_Actors
UNSC_	[IGOUNO] ;MleH 04 Aug 2009; NGO_Actors
UN_	[IGOUNO] ;CTA 14 Jul 2009; NGO_Actors
UN_BODIES_	[IGOUNO] ;MleH 28 Jul 2009; NGO_Actors
UN_ENVOY_	[IGOUNO] ;MleH 06 Aug 2009; NGO_Actors
UN_GENERAL_ASSEMBLY_	[IGOUNO] ;ELH 30 Jul 2009; NGO_Actors
UN_HIGH_COMMISSION_FOR_HUMAN_RIGHTS_	[IGOUNOHRIHCH]; NGO_Actors
UN_HIGH_COMMISSION_FOR_REFUGEES_	[IGOUNOREFHCR]; NGO_Actors
UN_MILLENNIUM_PROJECT_	[IGOUNODEV]; achieving UN Millennium Development Goals; NGO_Actors
UN_MISSION_	[IGOUNO] ;MleH 22 Jul 2009; NGO_Actors
UN_MISSION_IN_SUDAN_	[IGOUNO] ;BK 07 Jul 2009; NGO_Actors
UN_RESIDENT_	[IGOUNO] ;MleH 22 Jul 2009; NGO_Actors
UN_SECRETARIAT_	[IGOUNO]; NGO_Actors
UN_SECURITY_COUNCIL_	[IGOUNO] ;MleH 10 Jul 2009 and CTA 13 Jul 2009; NGO_Actors
UN_SPECIAL_ENVOY_FOR_BURMA_	[IGOUNO] ;MleH 07 Aug 2009; NGO_Actors
URBAN_AGRICULTURE_NETWORK_	[NGOAGR]; production of food within urban environments; NGO_Actors
US_BUSINESS_ROUNDTABLE_	[USABUS] ;CTA 20 Jul 2009; AllOtherCountries.txt
US_PACIFIC_FORCES_COMMANDER_ADMIRAL_TIMOTHY_KEATING_	[USAMIL] ;ELH 22 Jul 2009; AllOtherCountries.txt
US_STUDENT_	[USAEDU] ;MleH 09 Aug 2009; AllOtherCountries.txt
U_THANT_	[IGOUNO 611130-711231] [ELI]; IGOrulers.txt
VAESTOLIITTO_	[FINHLH]; AllOtherCountries.txt
VARIOUS_INTERNATIONAL_GROUPS_	[IGO/NGO] ;MleH 09 Aug 2009; NGO_Actors
VARSHA_MAHENDER_SABHNANI_	[USACRM] ;MleH 11 Aug 2009; AllOtherCountries.txt
VATICAN_	[VAT] ;ELH 06 Aug 2009; AllOtherCountries.txt
VELLORE_CHRISTIAN_MEDICAL_COLLEGE_BOARD_	[NGOINDCHRHLH]; NGO_Actors
VICTOR_LAROCK_	[IGOEUREEC 580101-580630] ; president of the CoEU from BELGIUM; IGOrulers.txt
VITAL_VOICES_	[NGO]; NGO_Actors
VOICES_OF_THE_NEXT_GENERATION_	[NGORELEDU]; NGO_Actors
VOLUNTEERS_IN_TECHNICAL_ASSISTANCE_	[NGOUSAMED]; provision of internet and technical info; NGO_Actors
V_H_DALMIYA_	[NGOHINRAD]; World Hindu Council; NGO_Actors
WAFD_PARTY_	[EGYOPPPTY] ;MleH 13 Aug 2009; AllOtherCountries.txt
WALL_STREET_JOURNAL_	[USAMED] ;CTA 21 Jul 2009; AllOtherCountries.txt
WARIPNET_	[NGOWAFREF]; NGO_Actors
WAR_CHILD_CANADA_	[NGOCAN]; NGO_Actors
WAR_CHILD_NETHERLANDS_	[NGONLD]; NGO_Actors
WAR_CHILD_UK_	[NGOGBR]; NGO_Actors
WAR_RESISTERS_INTERNATIONAL_	[NGO]; NGO_Actors
WASHINGTON_BASED_FREEDOM_HOUSE_	[NGOHRI] ;ELH 17 Jul 2009; NGO_Actors
WASHINGTON_DC_PRINCIPLES_FOR_FREE_ACCESS_TO_SCIENCE_	[NGOUSAEDU]; free access to scientific journals & findings; NGO_Actors
WASHINGTON_OFFICE_ON_AFRICA_	[USACVL]; AllOtherCountries.txt
WATCH_INDONESIA!	[NGOIDNTMP]; does the exclamation mark code correctly?; NGO_Actors
WATER_SUPPLY_AND_SANITATION_COLLABORATIVE_COUNCIL_	[NGOENV]; NGO_Actors
WEST_AFRICAN_DEVELOPMENT_BANK_	[IGOWAFWAD]; NGO_Actors
WEST_AFRICA_DEVELOPMENT_BANK_	[IGOWAFWAD]; NGO_Actors
WEST_AFRICA_MONETARY_AND_ECONOMIC_UNION_	[IGOWAFDEVWAM]; NGO_Actors
WEST_INDIES_	[CRB]; AllOtherCountries.txt
WE_THE_PEOPLE_INITIATIVE_	[USAEDU]; AllOtherCountries.txt
WFP_	[IGOUNOWFP] ;MleH 23 Jul 2009; NGO_Actors
WILDLIFE_AND_ENVIRONMENT_SOCIETY_OF_SOUTH_AFRICA_	[NGOZAFENV]; NGO_Actors
WILDLIFE_TRUST_	[NGOENV]; NGO_Actors
WILLY_CLAES_	[IGOEUREEC 930701-931231][IGOWSTNAT 941017-951020] ; president of the CoEU from BELGIUM; IGOrulers.txt
WOMANKIND_WORLDWIDE_	[NGO]; NGO_Actors
WOMEN'S_ACTION_FOR_NEW_DIRECTIONS_	[NGOUSA]; NGO_Actors
WOMEN'S_INTERNATIONAL_COALITION_FOR_ECONOMIC_JUSTICE_	[NGO]; NGO_Actors
WOMEN'S_LEARNING_PARTNERSHIP_	[NGO]; NGO_Actors
WOMEN'S_WORLD_SUMMIT_FOUNDATION_	[NGODEV]; NGO_Actors
WOMEN,_LAW,_AND_DEVELOPMENT_INTERNATIONAL_	[NGODEV]; NGO_Actors
WOMENACTION_	[NGOMED]; NGO_Actors
WOMEN_FOR_WOMEN_INTERNATIONAL_	[NGODEV]; NGO_Actors
WOMEN_IN_LAW_AND_DEVELOPMENT_IN_AFRICA_	[NGOAFRDEV]; NGO_Actors
WOMEN_IN_SECURITY,_CONFLICT_MANAGEMENT_AND_PEACE_	[NGOSAS]; NGO_Actors
WORLDWIDE_FUND_FOR_NATURE_	[NGOENV] ;MleH 20 Jul 2009; NGO_Actors
WORLD_ASSOCIATION_FOR_CHILDREN_AND_PARENTS_	[NGO]; Worldwide Adoption; NGO_Actors
WORLD_ASSOCIATION_FOR_THE_SCHOOL_AS_AN_INSTRUMENT_OF_PEACE_	[NGOHRI]; NGO_Actors
WORLD_BANK_	[IGOUNODEVWBK]; NGO_Actors
WORLD_BANK_FAMILY_NETWORK_BOOK_PROJECT_	[IGOUNODEVWBKEDU]; supporting children's education; NGO_Actors
WORLD_BUSINESS_COUNCIL_FOR_SUSTAINABLE_DEVELOPMENT_	[NGOENV]; NGO_Actors
WORLD_COMMISSION_ON_DAMS_	[NGOENV]; NGO_Actors
WORLD_COMMUNITY_	[INT] ;MleH 06 Aug 2009; AllOtherCountries.txt
WORLD_CONFERENCE_OF_RELIGIONS_FOR_PEACE_	[NGOREL]; NGO_Actors
WORLD_CONSERVATION_UNION_	[NGOENV]; NGO_Actors
WORLD_ECONOMIC_FORUM_	[NGOBUSWEF]; NGO_Actors
WORLD_FEDERATION_FOR_MENTAL_HEALTH_	[NGOHLH]; NGO_Actors
WORLD_FEDERATION_OF_DEMOCRATIC_YOUTH_	[NGO]; socialist org; NGO_Actors
WORLD_FEDERATION_OF_TRADE_UNIONS_	[NGOLAB]; NGO_Actors
WORLD_FEDERATION_OF_UKRANIAN_WOMEN'S_ORGANIZATIONS_	[NGOUKR]; NGO_Actors
WORLD_FEDERATION_OF_UNITED_NATIONS_ASSOCIATIONS_	[NGO]; NGO_Actors
WORLD_FOOD_PROGRAM_	[IGOUNOWFP]; emergency humanitarian aid has health intent, hence the designation; NGO_Actors
WORLD_HEALTH_ASSEMBLY_	[IGOUNOHLHWHO] ;MleH 04 Aug 2009; NGO_Actors
WORLD_HEALTH_ORGANIZATION_	[IGOUNOHLHWHO]; NGO_Actors
WORLD_INFORMATION_TRANSFER_	[NGOENV]; Environment issues, consultative status w/UN; NGO_Actors
WORLD_LEARNING_ARMENIA_	[NGOARM]; NGO_Actors
WORLD_LIBRARY_PARTNERSHIP_	[NGOEDU]; Literacy promotion in developing areas; NGO_Actors
WORLD_MARCH_OF_WOMEN_	[NGO]; NGO_Actors
WORLD_NEIGHBORS_	[NGODEV]; generalized development; NGO_Actors
WORLD_ORGANIZATION_AGAINST_TORTURE_	[NGOHRI]; NGO_Actors
WORLD_ORGANIZATION_FOR_HUMAN_RIGHTS_USA_	[NGOUSAHRI]; NGO_Actors
WORLD_PEACE_PRAYER_SOCIETY_	[NGOREL]; NGO_Actors
WORLD_POPULATION_FOUNDATION_	[NGONLDHLH]; NGO_Actors
WORLD_RAINFOREST_MOVEMENT_	[NGOENV]; NGO_Actors
WORLD_RESOURCES_INSTITUTE_	[NGOENV]; Climate Chage; NGO_Actors
WORLD_TRADE_ORGANISATION_	[IGOBUSWTO] ;MleH 21 Jul 2009; NGO_Actors
WORLD_TRADE_ORGANIZATION_	[IGOBUSWTO]; NGO_Actors
WORLD_TRADE_ORGANIZATION_TALK_	[IGOBUSWTO] ;MleH 15 Jul 2009; NGO_Actors
WORLD_UIGHUR CONGRESS_	[NGOCHNUIGHRI]; NGO_Actors
WORLD_UIGUR CONGRESS_	[NGOCHNUIGHRI]; NGO_Actors
WORLD_UYGHUR CONGRESS_	[NGOCHNUIGHRI]; NGO_Actors
WORLD_UYGHUR_YOUTHS_LEAGUE_	[NGOCHNUIGHRI]; NGO_Actors
WORLD_UYGUR CONGRESS_	[NGOCHNUIGHRI]; NGO_Actors
WORLD_VISION_	[NGOCHRDEV]; child sponsorship programs; NGO_Actors
WORLD_WATER_COUNCIL_	[NGOENV]; NGO_Actors
WORLD_WIDE_FUND_FOR_NATURE_	[NGOENV]; NGO_Actors
WORLD_WILDLIFE_FUND_	[NGOENV]; NGO_Actors
WORLD_YOUNG_WOMEN'S_CHRISTIAN_ASSOCIATION_	[NGOCHR]; NGO_Actors
WORLD_YOUNG_WOMEN'S_CHRISTIAN_ORGANIZATION_	[NGOCHR]; NGO_Actors
WTO_	[IGOBUSWTO]; World Trade Organization; NGO_Actors
WUYC_	[NGOCHNUIGHRI]; World Uyghur Congress; NGO_Actors
WWF_	[NGOENV]; wildlife protection but also sustainable development; NGO_Actors
WWF_INDIA_	[NGOENV] ;MleH 10 Aug 2009; NGO_Actors
YACHAY_WASI_(HOUSE_OF_LEARNING)	[NGOPER]; NGO_Actors
YEARBOOK_OF_INTERNATIONAL_COOPERATION_ON_ENVIRONMENT_AND_DEVELOPMENT_	[NGOENV]; NGO_Actors
YMCA_	[NGOCHR]; NGO_Actors
YONGE_NAWE_ENVIRONMENTAL_ACTION_GROUP_	[NGOSWZENV]; NGO_Actors
YOUNG_MEN'S_CHRISTIAN_ASSOCIATION_	[NGOCHR]; YMCA; NGO_Actors
YOUTH_ADVOCATE_PROGRAM_INTERNATIONAL_	[NGO]; NGO_Actors
YWCA_	[NGOCHR]; NGO_Actors
ZHAO_YAN_	[USAMED] ;MleH 08 Aug 2009; AllOtherCountries.txt
ZIMBABWE_HUMAN_RIGHTS_NGO_FORUM_	[NGOZWEHRI]; NGO_Actors
ZONTA_INTERNATIONAL_	[NGODEV]; NGO_Actors
Source: AllOtherINT.MLH.actors
A._M._ZAIDAN_	[QATMED]	; Al Jazeera correspondent
A._ZAIDAN_	[QATMED]	; Al Jazeera correspondent
A_M_ZAIDAN_	[QATMED]	; Al Jazeera correspondent
A_ZAIDAN_	[QATMED]	; Al Jazeera correspondent
AHMAD_MUAFFAQ_ZAIDAN_	[QATMED]	; Al Jazeera correspondent
AHMAD_ZAIDAN_	[QATMED]	; Al Jazeera correspondent
ALL_INDIA_DISASTER_MITIGATION_INSTITUTE_	[INDCVL]
BEIJING_ENTERPRISES_HOLDINGS_	[CHNGOVBUS]	; recoded from SAE files
CHINA_MERCHANTS_HOLDINGS_	[CHNGOVBUS]	; recoded from SAE files
CHINA_MINMETALS_CORP.	[CHNGOVBUS]	; recoded from SAE files
CHINA_NATIONAL_OFFSHORE_OIL_CORP_	[CHNGOVBUS]	; recoded from SAE files
CHINA_OCEAN_SHIPPING_	[CHNGOVBUS]	; recoded from SAE files
CHINA_RAILWAY_CONSTRUCTION_CORP_	[CHNGOVBUS]	; recoded from SAE files
CHINA_RESOURCES_ENTERPRISES_	[CHNGOVBUS]	; recoded from SAE files
CHINA_STATE_CONSTRUCTION_ENGINEERING_CORP_	[CHNGOVBUS]	; recoded from SAE files
CITIC_GROUP_	[CHNGOVBUS]	; recoded from SAE files
GUANGDONG_INVESTMENT_L	[CHNGOVBUS]	; recoded from SAE files
JOHN_J_MCCLOY_	[WBKDEV]
KREDITANSTALT_FUR_WIEDERAUFBAU_	[DEUGOVBUS]	; recoded from SAE files
LANDESBANK_BADEN-WURTTEMBERG_	[DEUGOVBUS]	; recoded from SAE files
OIL_AND_NATURAL_GAS_CORPORATION_	[INDGOVBUS]	; recoded from SAE files
SHOUGANG_CONCORD_	[CHNGOVBUS]	; recoded from SAE files
Source: IGO.MLH.actors
A._GAVAHI_	[IGOASABUS 000801-020731]	; Economic Cooperation Organization
A_GAVAHI_	[IGOASABUS 000801-020731]	; Economic Cooperation Organization
ABDALLAH_SALEM_EL-BADRI_	[IGOBUSOPC 940701-941231][IGOBUSOPC >070101]	; OPEC
ABDELOUAHED_BELKEZIZ_	[IGOMOS 010101-041231]	; Organisation of the Islamic Conference
ABDIRAHIN_HAITHAR_ABDI_	[IGOEAFEAC >070605]	; East African Community
ABDOLRAHIM_GAVAHI_	[IGOASABUS 000801-020731]	; Economic Cooperation Organization
ABDUL_RAHMAN_IBN_HAMAD_AL-ATTIYAH_	[IGOPGSGCC >020401]	; Gulf Cooperation Council
ABDULRAHMAN_KINANA_	[IGOEAFEAC 011129-070605]	; East African Community
ADALID_CONTRERAS_BASPINEIRO_	[IGOSAM >100507]	; Andean Community
ADNAN_SHIHAB-ELDIN_	[IGOBUSOPC 050101-051231]	; OPEC
ADWALDO_CARDOSO_BOTTO_DE_BARROS_	[IGO 850101-941231]	; Universal Postal Union
AFRICAN_CARIBBEAN_AND_PACIFIC_GROUP_OF_STATES_	[IGO]
AFRICAN_DEVELOPMENT_BANK_	[IGOAFRDEVAFB]
ALEXANDRE_LAMFALUSSY_	[IGOEUREEC 940101-970630]	; The EU
ALFREDO_FUENTES_HERNANDEZ_	[IGOSAM 060728-070201]	; Andean Community
ALI_RODRIGUEZ_ARAQUE_	[IGOBUSOPC 010101-020630]	; OPEC
ALI_TRIKI_	[IGOUNO 090915-100914]	; UN
ALVARO_SILVA_CALDERON_	[IGOBUSOPC 020701-031231]	; OPEC
AMARA_ESSY_	[IGOAFROAU 010917-020709][IGOAFRAFU 020709-030916]	; Afican Union
AMERICAN_CORRECTIONAL_ASSOCIATION_	[IGOUSACOP] ;MleH 01 Jul 2010
ANDEAN_COMMUNITY_	[IGOSAM]
ANDERS_NORDSTROM_	[IGOUNOHLHWHO 060522-070104]	; World Health Organization
ANKER_JORGENSEN_	[IGOSCN 910101-911231]	; Nordic Council
ANNE_KRUEGER_	[IGOBUSIMF 040304-040504]	; International Monetary Fund
ANTARCTIC_TREATY_	[IGO]
ANTHONY_CROSLAND_	[IGOEUREEC 770101-770630] ; president of the CoEU from UNITED_KINGDOM; IGOrulers.txt
ANTHONY_CROSLAND,_THEN_DAVID_OWEN_	[IGOEUREEC 770101-770630]	; European Community (EEC)
ANTONIO_ENRIQUEZ_SAVIGNAC_	[IGOUNOBUS 900101-960831]	; World Tourism Organization
ARAB_BANK_FOR_ECONOMIC_DEVELOMENT_IN_AFRICA_	[IGOARBDEVABD]
ARAB_TOWNS_ORGANIZATION_	[IGOARB] ;MleH 01 Jul 2010
ARNAUD_JACOMET_	[IGOEUREEC >091125]	; Western European Union
ARTHUR_DUNKEL_	[IGOBUSWTO 801001-930701]	; World Trade Organisation
ARTURO_HERRERA_VERDUGO_	[IGOCOPITP 080213-081010]	; Interpol
ASSAD_KOTAITE_	[IGOUNOBUS 760801-060731]	; International Civil Aviation Organization
ASSEMBLEE_PARLEMENTAIRE_DE_LA_FRANCOPHONIE_	[IGOLEG] ;MleH 01 Jul 2010
ASSOCIATION_MONDIALE_DES_AMIS_DE_L'ENFANCE_	[IGOHRI] ;MleH 01 Jul 2010
ATANRAOI_BAITEKE_	[IGO 890616-930105]	; Pacific Community
ATI_GEORGE_SOKOMANU_	[IGO 930106-960107]	; Pacific Community
AUGUSTO_VELA_MENA_	[IGOLAM 941028-951028]	; Central American Parliament	; Central American Parliament
BANK_OF_CENTRAL_AFRICAN_STATES_	[IGOAFRBCA]
BANTZ_J._CRADDOCK_	[IGOWSTNAT 061207-090702]	; NATO
BARBER_B._CONABLE_	[IGOUNODEVWBK 860701-910901]	; World Bank
BARON_ROBERTSON_	[IGOWSTNAT 991014-031217]	; NATO
BEAC_	[IGOAFRBCA]
BERIT_BRORBY_LARSEN_	[IGOSCN 980101-981231]	; Nordic Council
BERTRAND_RAMCHARAN_	[IGOUNO 030602-040701]	; UN
BOLAT_NURGALIYEV_	[IGOCAS 070101-100121]	; Shanghai Cooperation Organization
CARIBBEAN_COMMUNITY_	[IGOCRB]
CAROL_BELLAMY_	[IGOUNOKID 950501-050430]	; United Nations Children's Fund
CATHERINE_LALUMIERE_	[IGOEUREEC 890601-940531]	; Council of Europe
CEMAC_	[IGOCAFCEM]
CENTRAL_AMERICAN_PARLIAMENT_	[IGOLAM]
CHARLES_FRANK_	[IGOEURDEVEBR 980131-980901]	; European Bank for Reconstruction and Development	; European Bank for Reconstruction and Development
CHRISTIAN_CATHOLIC_	[IGOCHR]
CHRISTIAN_PROTESTANT_	[CHRPRO]
CHRISTOPHER_R._THOMAS_	[IGOOAS 940620-940915]	; Organization of American States
CIRO_CRUZ_ZEPEDA_	[IGOLAM 061030-071026]	; Central American Parliament
COCOA_PRODUCERS'_ALLIANCE_	[IGOAGRCPA]; NGO_Actors
COMMUNITY_OF_SAHEL_SAHARAN_STATES_	[IGONAFCSS]
DAME_ROSALYN_HIGGINS_	[IGO 060206-090206]	; International Court of Justice
DANIEL_TARSCHYS_	[IGOEUREEC 940620-990901]	; Council of Europe
DATUK_AJIT_SINGH_	[IGOSEAASN 930101-980105]	; Association of Southeast Asia Nations
DEVELOPING_EIGHT_COUNTRIES_	[IGODEVDVE]
DIDIER_OPERTTI_BADAN_	[IGOUNO 980909-990914]	; UN
DONALD_J._JOHNSTON_	[IGOWSTBUS 960601-060531]	; Organization for Economic Cooperation and Development
DORINDO_CORTEZ_	[IGOLAM >101028]	; Central American Parliament
DPKO_	[IGOUNO]
EAST_AFRICAN_COMMUNITY_	[IGOEAFEAC]
ECONOMIC_COOPERATION_ORGANIZATION_	[IGOASABUS]
EDOUARD_DAYAN_	[IGO >050101]	; Universal Postal Union
EDOUARD_SAOUMA_	[IGOAGR 760101-931231]	; Food and Agriculture Organization
EDWIN_W._CARRINGTON_	[IGOCRB 920801-101231]	; Caribbean Community
EFTHIMIOS_E._MITROPOULOS_	[IGO >040101]	; International Maritime Organization
EGON_KLEPSCH_	[IGOEUREEC 920114-940719]	; The EU
EMEKA_ANYAOKU_	[IGOCWN 900701-000403]	; The Commonwealth
ENRIQUE_BARON_CRESPO_	[IGOEUREEC 890725-920114]	; The EU
ENRIQUE_IGLESIAS_	[IGONAMDEV 880401-050930]	; Inter-American Development Bank
ERNESTO_LIMA_MENA_	[IGOLAM 961028-971028]	; Central American Parliament
ESMAT_ABDEL_MEGUID_	[IGOMEAARL 910515-010515]	; Arab League
FABIO_GADEA_MANTILLA_	[IGOLAM 041028-051028]	; Central American Parliament
FEDERICO_MAYOR_	[IGO 871115-991114]	; United Nations Educational, Scientific and Cultural Organization
FOOD_AND_AGRICULTURE_ORGANIZATION_	[IGOAGR]
FRANCESCO_FRANGIALLI_	[IGOUNOBUS 960901-090228]	; World Tourism Organization
FRANCIS_MUTHAURA_	[IGOEAFEAC 960314-010424]	; East African Community
FRANCISCO_MERINO_	[IGOLAM 940712-941028]	; Central American Parliament
GABRIEL_ROMANUS_	[IGOSCN 040101-041231]	; Nordic Council
GEORG_REISCH_	[IGOEURBUSEFT 880416-940831]	; European Free Trade Association
GEORGE_A._JOULWAN_	[IGOWSTNAT 931022-970711]	; NATO
GEORGE_GOODWIN_	[IGOCRB 010731-030512]	; Organization of Eastern Caribbean States
GEORGE_ROBERTSON_	[IGOWSTNAT 991014-031217]	; NATO
GERTRUDE_IBENGWE_MONGELLA_	[IGOAFRAFU 040318-090529]	; Afican Union
GIANCARLO_ARAGONA_	[IGOEUR 960615-990615]	; Organization for Security and Cooperation in Europe
GILBERT_GUILLAUME_	[IGO 000207-030206]	; International Court of Justice
GLORIA_GUADALUPE_OQUELI_	[IGOLAM 081028-091028]	; Central American Parliament
GUILLERMO_FERNANDEZ_DE_SOTO_	[IGOSAM 020919-040115]	; Andean Community
HABIB_BOULARES_	[IGOMEAAMU 020226-060201]	; Arab Maghreb Union
HAMADOUN_TOURE_	[IGOMED >070101]	; International Telecommunication Union
HAMMARSKJOLD)	[IGOUNO 530410-610918] [ELI]; IGOrulers.txt
HANS_BLIX_	[IGOUNOIAE 811201-971130]	; IAEA
HANS_DIETRICH_GENSCHER_	[IGOEUREEC 780701-781231]	; European Community (EEC)	; European Community (EEC)
HANS-GERT_POTTERING_	[IGOEUREEC 070116-090714]	; The EU
HARUHIKO_KURODA_	[IGOASADEVADB >050201]	; Asian Development Bank
HAYA_RASHED_AL_KHALIFAH_	[IGOUNO 060912-070918]	; UN
HELGI_HJORVAR_	[IGOSCN 100101-101231]	; Nordic Council
HENRIK_DAM_KRISTENSEN_	[IGOSCN >110101]	; Nordic Council
HINDU_	[HIN]
HIROSHI_NAKAJIMA_	[IGOUNOHLHWHO 880721-980721]	; World Health Organization
HISASHI_OWADA_	[IGO >090206]	; International Court of Justice as
HUGO_GUIRAUD_GARGANO_	[IGOLAM 001028-011028]	; Central American Parliament
IDRISS_NDELE_MOUSSA_	[IGOAFRAFU >090529]	; Afican Union
ILSA_DIAZ_ZELAYA_	[IGOLAM 921028-931028]	; Central American Parliament
INGE_LONNING_	[IGOSCN 030101-031231]	; Nordic Council
INTER_AMERICAN_DEVELOPMENT_BANK_	[IGONAMDEV]
INTERNATIONAL_CIVIL_AVIATION_ORGANIZATION_	[IGOUNOBUS]
INTERNATIONAL_CRIMINAL_POLICE_ORGANIZATION_	[IGOCOPITP]	; Interpol
INTERNATIONAL_GOVERNMENT_ORGANISATION_	[IGO]
INTERNATIONAL_GOVERNMENT_ORGANIZATION_	[IGO]
INTERNATIONAL_LABOUR_ORGANIZATION_	[IGOUNOLABILO]; NGO_Actors
INTERNATIONAL_MARITIME_ORGANIZATION_	[IGO]
ISLAMIC_CHAMBER_OF_COMMERCE_AND_INDUSTRY_	[IGOMOSOICBUS] ;MleH 01 Jul 2010
IVAN_KOROTCHENYA_	[IGOCASCIS 990304-990402]	; Commonwealth of Independent States
JACINTO_SUAREZ_	[IGOLAM 091028-101028]	; Central American Parliament
JACKIE_SELEBI_	[IGOCOPITP 041008-080213]	; Interpol
JACQUES_ATTALI_	[IGOEURDEVEBR 910415-930716]	; European Bank for Reconstruction and Development
JACQUES_DELORS_	[IGOEUREEC 850115-950105]	; The EU
JACQUES_DIOUF_	[IGOAGR >940101]	; Food and Agriculture Organization
JAMES_D._WOLFENSOHN_	[IGOUNODEVWBK 950601-050601]	; World Bank
JAMES_G._STAVRIDIS_	[IGOWSTNAT >090702]	; NATO
JAMES_GRANT_	[IGOUNOKID 800101-950128]	; United Nations Children's Fund
JAN_HUBER_	[IGO 040901-090901]	; Antarctic Treaty
JEAN_LEMIERRE_	[IGOEURDEVEBR 000703-080703]	; European Bank for Reconstruction and Development
JEAN-CLAUDE_PAYE_	[IGOWSTBUS 840930-940929]	; Organization for Economic Cooperation and Development	; Organization for Economic Cooperation and Development
JEAN-ROBERT_GOULONGANA_	[IGO 000301-050228]	; African, Caribbean and Pacific Group of States
JESUS_ESPIGARES_MIRA_	[IGO 001103-041008]	; International Criminal Police Organization
JIMMIE_RODGERS_	[IGO >060123]	; Pacific Community
JIRI_DIENSTBIER_	[IGOEUR 920101-920702]	; Organization for Security and Cooperation in Europe
JOAO_BAENA_SOARES_	[IGOOAS 840620-940620]	; Organization of American States
JOHN_GALVIN_	[IGOWSTNAT 870626-920623]	; NATO
JOHN_SHALIKASHVILI_	[IGOWSTNAT 920623-931022]	; NATO
JOSE_ANGEL_GURRIA_TREVINO_	[IGOWSTBUS >060601]	; Organization for Economic Cooperation and Development
JOSE_AYALA_LASSO_	[IGOUNO 940405-970315]	; UN
JOSE_CUTILEIRO_	[IGOEUREEC 941116-991124]	; Western European Union
JOSE_ERNESTO_SOMARRIBA_SOSA_	[IGOLAM 991028-001028]	; Central American Parliament
JOSE_FRANCISCO_GUERRERO_MUNGUIA_	[IGOLAM 931028-940704]	; Central American Parliament
JOSE_MARIA_GIL-ROBLES_	[IGOEUREEC 970114-990720]	; The EU
JOSE_MARIA_RUDA_	[IGO 880224-910207]	; International Court of Justice
JOSEP_BORRELL_	[IGOEUREEC 040720-070116]	; The EU
JOSEPH_NANVEN_GARBA_	[IGOUNO 890919-900918]	; UN
JOSEPH_W._RALSTON_	[IGOWSTNAT 000503-030117]	; NATO
JUAN_SOMAVIA_	[IGOUNOLABILO >990304]	; International Labour Organization
JULIO_GUILLERMO_GONZALEZ_GAMARRA_	[IGOLAM 071026-081028]	; Central American Parliament
JULIO_PALACIOS_	[IGOLAM 051028-061030]	; Central American Parliament
JUMA_VOLTER_MWAPACHU_	[IGOEAFEAC >060425]	; East African Community
K._ANNAN_	[IGOUNO 970101-061231] [ELI]	; UN
K_ANNAN_	[IGOUNO 970101-061231] [ELI]	; UN
KAIRE_MBUENDE_	[IGOSAFDEVSAD 940101-991231]	; Southern African Development Community
KAMALESH_SHARMA_	[IGOCWN >080401]	; The Commonwealth
KANT_KISHORE_BHARGAVA_	[IGOSASSAA 891017-911231]	; South Asian Association (for Regional Cooperation)
KARE_BRYN_	[IGOEURBUSEFT >060901]	; European Free Trade Association
KHOO_BOON_HUI_	[IGO >081010]	; International Criminal Police Organization
KIMIMASA_TARUMIZU_	[IGOASADEVADB 891124-931123]	; Asian Development Bank
KJARTAN_JOHANNSSON_	[IGOEURBUSEFT 940901-000831]	; European Free Trade Association
KLAUS_HANSCH_	[IGOEUREEC 940719-970114]	; The EU
KOFI_ATTA_ANNAN_	[IGOUNO 970101-061231] [ELI]
KOICHIRO_MATSUURA_	[IGO 991115-091114]	; United Nations Educational, Scientific and Cultural Organization
KYUNG-WHA_KANG_	[IGOUNO 080701-080831]	; UN
LA_FRANCOPHONIE_	[IGO]
LAMBERTO_DINI,_THEN_ROMANO_PRODI_	[IGOEUREEC 960101-960630]	; European Community (EEC)
LEE_JONG_WOOK_	[IGOUNOHLHWHO 030721-060522]	; World Health Organization
LEN_ISHMAEL_	[IGOCRB >030512]	; Organization of Eastern Caribbean States
LOLITA_APPLEWHAITE_	[IGOCRB >110101]	; Caribbean Community
LOURDES_PANGELINAN_	[IGO 000106-060123]	; Pacific Community
LUIGI_R._EINAUDI_	[IGOOAS 041015-050526]	; Organization of American States
LUIS_ALBERTO_MORENO_	[IGONAMDEV >051001]	; Inter-American Development Bank
MANFRED_REINKE_	[IGO >090901]	; Antarctic Treaty
MANFRED_WERNER_	[IGOWSTNAT 880701-940813]	; NATO
MANFRED_WORNER_	[IGOWSTNAT 880701-940813]	; NATO
MARC_PERRIN_DE_BRICHAMBAUT_	[IGOEUR >050621]	; Organization for Security and Cooperation in Europe
MARCO_ANTONIO_SOLARES_PEREZ_	[IGOLAM 971028-981028]	; Central American Parliament
MARGARET_CHAN_	[IGOUNOHLHWHO >070104]	; World Health Organization
MARIO_FACUSSE_HANDAL_	[IGOLAM 031028-041028]	; Central American Parliament
MAUD_DE_BOER-BUQUICCHIO_	[IGOEUREEC 090901-091001]	; Council of Europe
MAYORS_FOR_PEACE_	[IGO] ;MleH 01 Jul 2010
MICHEL_HANSENNE_	[IGOUNOLABILO 890227-990304]	; International Labour Organization
MIGUEL_D'ESCOTO_BROCKMANN_	[IGOUNO 080916-090915]	; UN
MITSUO_SATO_	[IGOASADEVADB 931124-990115]	; Asian Development Bank
MOHAMED_AMAMOU_	[IGOMEAAMU 911023-020226]	; Arab Maghreb Union
MOHAMED_IBN_CHAMBAS_	[IGOWAFWAS >100301]	; Economic Community of West African States
MOHAMMED_S._BARKINDO_	[IGOBUSOPC 060101-061231]	; OPEC
MONUC_INDIAN_CONTINGENT_	[IGOUNO]
MUHAMMAD_AL-BARADEI_	[IGOUNOIAE 971201-091130][EGYOPP]	; IAEA
NAEEM_U._HASAN_	[IGOSASSAA 960101-981231]	; South Asian Association (for Regional Cooperation)
NAVANETHEM_PILLAY_	[IGOUNO >080901]	; UN
NG'ANDU_MAGANDE_	[IGO 960716-000229]	; African, Caribbean and Pacific Group of States
NIHAL_RODRIGO_	[IGOSASSAA 990101-020110]	; South Asian Association (for Regional Cooperation)
NORDIC_COUNCIL_	[IGOSCN]
NUWE_AMANYA_MUSHEGA_	[IGOEAFEAC 010424-060424]	; East African Community
OLE_STAVAD_	[IGOSCN 060101-061231]	; Nordic Council
OLOF_SALMEN_	[IGOSCN 970101-971231]	; Nordic Council
OMAR_KABBAJ_	[IGOAFRDEVAFB 950901-050901]	; African Development Bank
ORA_INTERNATIONAL_	[IGOCHR]
ORGANISATION_FOR_ECONOMIC_COOPERATION_AND_DEVELOPMENT_	[IGOWSTBUS]
ORGANISATION_FOR_SECURITY_AND_COOPERATION_IN_EUROPE_	[IGO]
ORGANISATION_FOR_SECURITY_AND_CO-OPERATION_IN_EUROPE_	[IGO]
ORGANISATION_OF_EASTERN_CARIBBEAN_STATES_	[IGOCRB]
ORGANIZATION_FOR_ECONOMIC_COOPERATION_AND_DEVELOPMENT_	[IGOWSTBUS]
ORGANIZATION_FOR_SECURITY_AND_COOPERATION_IN_EUROPE_	[IGO]
ORGANIZATION_FOR_SECURITY_AND_CO-OPERATION_IN_EUROPE_	[IGO]
ORGANIZATION_OF_EASTERN_CARIBBEAN_STATES_	[IGOCRB]
ORGANIZATION_OF_WORLD_HERITAGE_CITIES_	[IGO] ;MleH 01 Jul 2010
OSMAN_OLCAY_	[IGOWSTNAT 690101-711231]; IGOrulers.txt
OSMAN_OLCAY_TURKEY_	[IGOWSTNAT 690101-711231]
OUTI_OJALA_	[IGOSCN 020101-021231]	; Nordic Council
PACIFIC_COMMUNITY_	[IGO]
PALL_PETURSSON_	[IGOSCN 900101-901231]	; Nordic Council
PARLACEN_	[IGOLAM]
PARLIAMENTARIANS_FOR_GLOBAL_ACTION_	[IGOLEG] ;MleH 01 Jul 2010
PAT_COX_	[IGOEUREEC 020115-040720]	; The EU
PEKKA_TARJANNE_	[IGOMED 891101-990131]	; International Telecommunication Union
PETER_SUTHERLAND_	[IGOBUSWTO 930701-950501]	; World Trade Organisation
PHILIPPE_KIRSCH_	[IGOJUDICC 030311-090311]	; International Criminal Court
PHILIPPE_ROCHAT_	[IGOUNOBUS 910801-970731]	; International Civil Aviation Organization
PREGA_RAMSAMY_	[IGOSAFDEVSAD 000101-050831]	; Southern African Development Community
Q.A.M.A._RAHIM_	[IGOSASSAA 020111-050228]	; South Asian Association (for Regional Cooperation)
RALPH_ZACKLIN_	[IGOUNO 970315-970912]	; UN
RANNVEIG_GUDMUNDSDOTTIR_	[IGOSCN 050101-051231]	; Nordic Council
RAUL_ZALDIVAR_GUZMAN_	[IGOLAM 951206-961028]	; Central American Parliament
RAYMOND_BENJAMIN_	[IGOUNOBUS >090801]	; International Civil Aviation Organization
RAZALI_ISMAIL_	[IGOUNO 960917-970916]	; UN
RENATO_CLAUDIO_COSTA_PEREIRA_	[IGOUNOBUS 970801-030731]	; International Civil Aviation Organization
RICHARD_FRANK_	[IGOUNODEVWBK 950504-950601]	; World Bank
ROBERT_B._DUN_	[IGO 960108-000105]	; Pacific Community
ROBERTO_CARPIO_NICOLLE_	[IGOLAM 911028-921028]	; Central American Parliament
ROBERTO_KOBEH_GONZALEZ_	[IGOUNOBUS >060801]	; International Civil Aviation Organization
RODOLFO_C._SEVERINO_	[IGOSEAASN 980105-030106]	; Association of Southeast Asia Nations
RODRIGO_SAMAYOA_RIVAS_	[IGOLAM 011028-021028]	; Central American Parliament
ROLAND_VALENZUELA_OYUELA_	[IGOLAM 951028-951202]	; Central American Parliament
RON_FREEMAN_	[IGOEURDEVEBR 930716-930927]	; European Bank for Reconstruction and Development
RONALD_K._NOBLE_	[IGO >001102]	; International Criminal Police Organization
RUSLI_NOOR_	[IGOSEAASN 890717-930101]	; Association of Southeast Asia Nations
SADAKO_OGATA_	[IGOUNO 910101-001231]	; UN
SALIM_AHMED_SALIM_	[IGOAFRAFU 890919-010917]	; Afican Union
SAMIR_S._SHIHABI_	[IGOUNO 910917-920915]	; UN
SAMUEL_R._INSANALLY_	[IGOUNO 930921-940920]	; UN
SANG-HYUN_SONG_	[IGOJUDICC >090311]	; International Criminal Court
SEBASTIAN_ALEGRETT_	[IGOSAM 970801-020807]	; Andean Community
SHANGHAI_COOPERATION_ORGANIZATION_	[IGOCAS]
SHEEL_KANTA_SHARMA_	[IGOSASSAA >080301]	; South Asian Association (for Regional Cooperation)
SHEIKH_AHMAD_FAHAD_AL_AHMAD_AL_	[IGOBUSOPC 050101-051231]	; OPEC
SHI_JIUYONG_	[IGO 030206-060206]	; International Court of Justice
SHIVINDER_SINGH_SIDHU_	[IGOUNOBUS 880801-910731]	; International Civil Aviation Organization
SIGRIDUR_ANNA_THORDARDOTTIR_	[IGOSCN 000101-001231]	; Nordic Council
SINIKKA_BOHLIN_	[IGOSCN 090101-091231]	; Nordic Council
SIR_JOHN_KAPUTIN_	[IGO 050301-100228]	; African, Caribbean and Pacific Group of States
SIR_SHRIDATH_RAMPHAL_	[IGOCWN 750701-900630]	; The Commonwealth
STAFFAN_SOHLMAN_	[IGOWSTBUS 940930-941129]	; Organization for Economic Cooperation and Development
STEPHEN_M._SCHWEBEL_	[IGO 970206-000207]	; International Court of Justice
SUBROTO_	[IGOBUSOPC 880701-940630]	; OPEC
SUPACHAI_PANITCHPAKDI_	[IGOBUSWTO 020901-050901]	; World Trade Organisation
TADAO_CHINO_	[IGOASADEVADB 990116-050201]	; Asian Development Bank
TAIEB_CHERIF_	[IGOUNOBUS 030801-090731]	; International Civil Aviation Organization
THOMAS_E._LEAVEY_	[IGO 950101-041231]	; Universal Postal Union
THOMAS_MIROW_	[IGOEURDEVEBR >080703]	; European Bank for Reconstruction and Development
TOMAZ_SALOMAO_	[IGOSAFDEVSAD >050901]	; Southern African Development Community
UNESCO_	[IGOUNODEV]
UNION_OF_SOUTH_AMERICAN_NATIONS_	[IGOSAM]
UNITED_CITIES_AND_LOCAL_GOVERNMENTS_	[IGO] ;MleH 01 Jul 2010
UNITED_NATIONS COMMISSION_FOR_HUMAN_RIGHTS_	[IGOUNOHRIHCH]; NGO_Actors
UNITED_NATIONS COMMISSION_FOR_REFUGEES_	[IGOUNOREFHCR]; NGO_Actors
UNITED_NATIONS_EDUCATIONAL,_SCIENTIFIC_AND_CULTURAL_ORGANIZATION_	[IGOUNODEV]
UNIVERSAL_POSTAL_UNION_	[IGO]
VICTOR_GBEHO_	[IGOWAFWAS >100216]	; Economic Community of West African States
WALTER_SCHWIMMER_	[IGOEUREEC 990901-040901]	; Council of Europe
WARSAW_TREATY_ORGANIZATION_	[IGOEEU 550514-910701]	; This ought to be given its own code (or we could create an "East Bloc" code)
WENDY_CHAMBERLIN_	[IGOUNO 050224-050615]	; UN
WESLEY_K._CLARK_	[IGOWSTNAT 970711-000503]	; NATO
WESTERN_EUROPEAN_UNION_	[IGOEUREEC]
WILHELM_HOYNCK_	[IGOEUR 930615-960615]	; Organization for Security and Cooperation in Europe
WILLIAM_A._O'NEIL_	[IGO 900101-031231]	; International Maritime Organization
WILLIAM_ROSSIER_	[IGOEURBUSEFT 000901-060831]	; European Free Trade Association
WIM_DUISENBERG_	[IGOEUREEC 970701-980531]	; The EU	; The EU
WIM_VAN_EEKELEN_	[IGOEUREEC 890515-941115]	; Western European Union
WORLD_FAMILY_ORGANIZATION_	[IGODEV] ;MleH 01 Jul 2010
WORLD_TOURISM_ORGANIZATION_	[IGOUNOBUS]
YADAV_KANT_SILWAL_	[IGOSASSAA 940101-951231]	; South Asian Association (for Regional Cooperation)
YAHYA_MAROOFI_	[IGOASABUS 090801-120831]	; Economic Cooperation Organization
YOSHIO_UTSUMI_	[IGOMED 990201-061231]	; International Telecommunication Union
YUKIYA_AMANO_	[IGOUNOIAE >091201]	; IAEA
ZHANG_DEGUANG_	[IGOCAS 040115-061231]	; Shanghai Cooperation OrganizationSource: IMG.MLH.actors
Source: MNC.MLH.actors
AAPSO_	[NGOHRI] ;MleH 01 Jul 2010
ABANTU_FOR_DEVELOPMENT_	[NGOEURDEV] ;MleH 01 Jul 2010
ACADEMIC_COUNCIL_ON_THE_UNITED_NATIONS_SYSTEM_	[NGO] ;MleH 01 Jul 2010
ACADEMY_FOR_FUTURE_SCIENCE_	[NGOUSA] ;MleH 01 Jul 2010
ACADEMY_OF_BREASTFEEDING_MEDICINE_	[NGOUSAHLH] ;MleH 01 Jul 2010
ACADEMY_OF_CRIMINAL_JUSTICE_SCIENCE_	[NGOUSAJUD] ;MleH 01 Jul 2010
ACCION_CONTRA_EL_HAMBRE_	[NGOHLH]
ACDF_	[NGOAFRDEV] ;MleH 01 Jul 2010
ACEEEO_	[NGOEEUDEV] ;MleH 01 Jul 2010
ACHARYA_G_KISHORE_	[NGOHIN]
ACJS_	[NGOUSAJUD] ;MleH 01 Jul 2010
ACRONYM_INSTITUTE_FOR_DISARMAMENT_DIPLOMACY_	[NGO] ;MleH 01 Jul 2010
ACT_ALLIANCE_	[NGOCHR]
ACTION_CONTRE_LA_FAIM_	[NGOHLH]
ACTION_INTERNATIONALE_CONTRE_LA_FAIM_	[NGO] ;MleH 01 Jul 2010
ACTION_MEDEOR_	[NGODEUHLH]
ACUNS_	[NGO] ;MleH 01 Jul 2010
ADVENTIST_DEVELOPMENT_&_RELIEF_AGENCY_	[NGOCHRPRODEV]; NGO_Actors
ADVENTIST_DEVELOPMENT_AND_RELIEF_AGENCY_	[NGOCHRPRODEV]; NGO_Actors
AEGEE_	[NGOEUREDU] ;MleH 01 Jul 2010
AEGIS_TRUST_	[NGOGBRHRI] ;MleH 01 Jul 2010
AFGHANAID_	[NGOAFGDEV]
AFRICA_AMERICA_INSTITUTE_	[NGOUSAEDU] ;MleH 01 Jul 2010
AFRICA_HUMANITARIAN_ACTION_	[NGOAFRHLH]
AFRICA_MUSLIM_AGENCY_	[NGOKWT] ;MleH 01 Jul 2010
AFRICA_MUSLIMS_AGENCY_	[NGOKWT] ;MleH 01 Jul 2010
AFRICAN_ACTION_ON_AIDS_	[NGOAFRHLH] ;MleH 01 Jul 2010
AFRICAN_BRAILLE_CENTER_	[NGOAFR] ;MleH 01 Jul 2010
AFRICAN_CITIZENS_DEVELOPMENT_FOUNDATION_	[NGOAFRDEV] ;MleH 01 Jul 2010
AFRICAN_DEVELOPMENT_INSTITUTE_INC.	[NGOAFRDEV]; NGO_Actors
AFRICAN_MEDICAL_&_RESEARCH_FOUNDATION_	[NGOAFRHLH] ;MleH 01 Jul 2010
AFRO_ASIAN_PEOPLES_SOLIDARITY_ORGANIZATION_	[NGOHRI] ;MleH 01 Jul 2010
AFRO_ASIAN_PEOPLE'S_SOLIDARITY_ORGANIZATION_	[NGOHRI] ;MleH 01 Jul 2010
AFRO_ASIAN_PEOPLES'_SOLIDARITY_ORGANIZATION_	[NGOHRI] ;MleH 01 Jul 2010
AFUSA_INC_	[NGOUSADEV] ;MleH 01 Jul 2010
AFXB_	[NGODEV] ;MleH 01 Jul 2010
AGA_KHAN_FOUNDATION_	[NGOMOSSHI] ;MleH 01 Jul 2010
AGENCE_D'AIDE_A_LA_COOPERATION_TECHNIQUE_ET_AU_DEVELOPPEMENT_	[NGODEV]
AGENCE_INTERNATIONALE_POUR_LE_DEVELOPPEMENT_	[NGOEURDEV] ;MleH 01 Jul 2010
AGENCY_FOR_TECHNICAL_COOPERATION_AND_DEVELOPMENT_	[NGODEV]
AGRICULTURAL_MISSIONS_INC.	[NGOCHRDEVAGR] ;MleH 01 Jul 2010
AICF_	[NGO] ;MleH 01 Jul 2010
AIDE_MEDICALE_INTERNATIONALE_	[NGOFRAHLH]
AIESEC_	[NGOEDU] ;MleH 01 Jul 2010
AIHRA_	[NGOINDHRI] ;MleH 01 Jul 2010
AIPET_INTERNACIONAL_	[NGOLAMMED] ;MleH 01 Jul 2010
AIPPI_	[NGOBUS] ;MleH 01 Jul 2010
AIR_SERV_INTERNATIONAL_	[NGOUSA]
AIRLINE_AMBASSADORS_	[NGOUSADEV] ;MleH 01 Jul 2010S
AJJDC_	[NGOUSAJEW]
AKTION_DEUTSCHLAND_HILFT_	[NGODEU]
ALBERT_SCHWEITZER_FELLOWSHIP_	[NGOUSAEDU] ;MleH 01 Jul 2010
ALBERT_SCHWEITZER_INSTITUTE_FOR_THE_HUMANITIES_	[NGOUSAEDU] ;MleH 01 Jul 2010
ALDHU_	[NGOLAMHRI] ;MleH 01 Jul 2010
ALFABETIZACAO_SOLIDARIA_	[NGOBRAEDU] ;MleH 01 Jul 2010
ALFASOL_	[NGOBRAEDU] ;MleH 01 Jul 2010
ALL_INDIA_HUMAN_RIGHTS_ASSOCIATION_	[NGOINDHRI] ;MleH 01 Jul 2010
ALLIANCE_INTERNATIONALE_DE_TOURISME_	[NGOBUS] ;MleH 01 Jul 2010
ALLIANCE_TOWARDS_HARNESSING_GLOBAL_OPPORTUNITIES_	[NGOUSA] ;MleH 01 Jul 2010
ALPHA_KAPPA_ALPHA_	[NGOUSAEDU] ;MleH 01 Jul 2010
ALTRUSA_	[NGOUSA] ;MleH 01 Jul 2010
AMERICAN_COMMITTEE_ON_AFRICA_	[NGOUSAHRI] ;MleH 01 Jul 2010
AMERICAN_COUNCIL_OF_YOUNG_POLITICAL_LEADERS_	[NGOUSAEDU] ;MleH 01 Jul 2010
AMERICAN_FOREIGN_LAW_ASSOCIATION_	[NGOUSAJUD] ;MleH 01 Jul 2010
AMERICAN_GEOGRAPHICAL_SOCIETY_	[NGOUSA] ;MleH 01 Jul 2010
AMERICAN_JEWISH_JOINT_DISTRIBUTION_COMMITTEE_	[NGOUSAJEW]
AMERICAN_JEWISH_WORLD_SERVICE_	[NGOUSAJEWDEV] ;MleH 01 Jul 2010
AMERICAN_SOCIETY_OF_INTERNATIONAL_LAW_	[NGOUSAJUD] ;MleH 01 Jul 2010
AMERICAN_SOCIETY_OF_MEDIA_PHOTOGRAPHERS_	[NGOUSAMED] ;MleH 01 Jul 2010
AMERICAN_WATER_WORKS_ASSOCIATION_	[NGOUSADEV] ;MleH 01 Jul 2010
AMERICARES_	[NGOUSAHLH]
AMIT_	[NGOUSAJEW] ;MleH 01 Jul 2010
AMREF_	[NGOAFRHLH] ;MleH 01 Jul 2010
AMURT_	[NGODEV] ;MleH 01 Jul 2010
ANANDA_MARGA_UNIVERSAL_RELIEF_TEAM_	[NGOHINDEN211DEV] ;MleH 01 Jul 2010 !!uses CAMEORCS 1.0
ANDHRA_PRADESH_CIVIL_LIBERTIES_	[NGOHRI]
ANTI_DEFAMATION_LEAGUE_	[NGOUSAJEW] ;MleH 01 Jul 2010
ANUVIBHA_	[NGOINDHIN] ;MleH 01 Jul 2010
ANUVRAT_GLOBAL_ORGANIZATION_	[NGOINDHIN] ;MleH 01 Jul 2010
APIMONDIA_	[NGOAGR] ;MleH 01 Jul 2010
ARAB_CENTER_FOR_STRATEGIC_STUDIES_	[NGOARB] ;MleH 01 Jul 2010
ARAB_INSTITUTE_FOR_HUMAN_RIGHTS_	[NGOARBHRI] ;MleH 01 Jul 2010
ARAB_INTERNATIONAL_ASSOCIATION_FOR_TOURISM_AND_AUTOMOBILE_CLUBS_	[NGOARBBUS] ;MleH 01 Jul 2010
ARAB_NGO_NETWORK_FOR_DEVELOPMENT_	[NGOARBDEV] ;MleH 01 Jul 2010
ARAB_SOCIETY_FOR_CERTIFIED_ACCOUNTANTS_	[NGOARBBUS] ;MleH 01 Jul 2010
ARAB_SOCIETY_FOR_INTELLECTUAL_PROPERTY_	[NGOARBBUS] ;MleH 01 Jul 2010
ARAB_SOCIETY_OF_CERTIFIED_ACCOUNTANTS_	[NGOARBBUS] ;MleH 01 Jul 2010
ARBEITER_SAMARITER_BUND_	[NGODEU]
ARCHITECTS_DESIGNERS_PLANNERS_FOR_SOCIAL_RESPONSIBILITY_	[NGOUSA] ;MleH 01 Jul 2010
AREG_SCIENTIFIC_CULTURAL_YOUTH_ASSOCIATION_	[NGOARM] ;MleH 01 Jul 2010
ARIYANAYAGAM_CHANDRA_NEHRU_	[NGOTAM]
ARMENIA_FUND_USA_	[NGOUSADEV] ;MleH 01 Jul 2010
ARMENIAN_ASSEMBLY_OF_AMERICA_	[NGOUSA] ;MleH 01 Jul 2010
ARMENIAN_GENERAL_BENEVOLENT_UNION_	[NGO] ;MleH 01 Jul 2010
ARMENIAN_RELIEF_SOCIETY_	[NGO] ;MleH 01 Jul 2010
ART_FOR_THE_WORLD_	[NGOMED] ;MleH 01 Jul 2010
ASIAN_DISASTER_PREPAREDNESS CENTER_	[NGOTHA]
ASIAN_PACIFIC_YOUTH_FORUM_	[NGOASA] ;MleH 01 Jul 2010
ASIAN_YOUTH_COUNCIL_	[NGOASAHRI] ;MleH 01 Jul 2010
ASOCIACION_IBEROAMERICANA_DE_PERIODISTAS_ESPECIALIZADOS_Y_TECNICOS_	[NGOLAMMED] ;MleH 01 Jul 2010
ASOCIACION_LATINOAMERICANA_DE_INSTITUCIONES_FINANCIERAS_DE_DESARROLLO_	[NGOLAMBUS] ;MleH 01 Jul 2010
ASOCIACION_LATINOAMERICANA_PARA_LOS_DERECHOS_HUMANOS_	[NGOLAMHRI] ;MleH 01 Jul 2010
ASSISTENCIA_MEDICA_INTERNACIONAL_	[NGOPRT]
ASSOCIATION_DES_ETATS_GENERAUX_DES_ETUDIANTS_DE_L'EUROPE_	[NGOEUREDU] ;MleH 01 Jul 2010
ASSOCIATION_DES_ETUDES_INTERNATIONALES_	[NGOEDU] ;MleH 01 Jul 2010
ASSOCIATION_FOR_AID_AND_RELIEF_	[NGOJPNHLH]
ASSOCIATION_FOR_CHILDHOOD_EDUCATION_	[NGOEDU] ;MleH 01 Jul 2010
ASSOCIATION_FOR_WOMEN_IN_PSYCHOLOGY_	[NGOUSAEDU] ;MleH 01 Jul 2010
ASSOCIATION_FOR_WOMEN'S_RIGHTS_IN_DEVELOPMENT_	[NGOCANHRI] ;MleH 01 Jul 2010
ASSOCIATION_FRANCOIS_XAVIER_BAGNOUD_	[NGODEV] ;MleH 01 Jul 2010
ASSOCIATION_FRANCOPHONE_D'AMITIE_ET_DE_LIAISON_	[NGO] ;MleH 01 Jul 2010
ASSOCIATION_INTERNATIONALE_DE_LA_SAVONNERIE,_DE_LA_DETERGENCE_ET_DES_PRODUITS_D'ENTRETIEN_	[NGOEURBUS] ;MleH 01 Jul 2010
ASSOCIATION_INTERNATIONALE_DES_JEUNES_AVOCAT_	[NGOJUD] ;MleH 01 Jul 2010
ASSOCIATION_INTERNATIONALE_POUR_LA_DEFENSE_DE_LA_LIBERTE_RELIGIEUSE_	[NGOEURHRI] ;MleH 01 Jul 2010
ASSOCIATION_INTERNATIONALE_POUR_LA_PROTECTION_DE_LA_PROPRIETE_INTELLECTUELLE_	[NGOBUS] ;MleH 01 Jul 2010
ASSOCIATION_MONDIALE_POUR_L'ECOLE_INSTRUMENT_DE_PAIX_	[NGO] ;MleH 01 Jul 2010
ASSOCIATION_MONTESSORI_INTERNATIONALE_	[NGOEDU] ;MleH 01 Jul 2010
ASSOCIATION_OF_CENTRAL_AND_EASTERN_EUROPEAN_ELECTION_OFFICIALS_	[NGOEEUDEV] ;MleH 01 Jul 2010
ASSOCIATION_OF_FORMER_INTERNATIONAL_CIVIL_SERVANTS_	[NGO] ;MleH 01 Jul 2010
ASSOCIATION_OF_INTERNATIONAL_EDUCATORS_	[NGOUSAEDU] ;MleH 01 Jul 2010
ASSOCIATION_OF_JUNIOR_LEAGUES_	[NGONMR] ;MleH 01 Jul 2010
ASSOCIATION_OF_MEDICAL_DOCTORS_OF_ASIA_	[NGOASAHLH] ;MleH 01 Jul 2010
ASSOCIATION_OF_NETWORK_FOR_COMMUNITY_EMPOWERMENT_	[NGOPAKHRI] ;MleH 01 Jul 2010
ASSOCIATION_TUNISIENNE_DES_MERES_	[NGOTUN] ;MleH 01 Jul 2010
ASSOCIAZIONE_CULTURALE_DEI_TRIANGOLI_E_DELLA_BUONA_VOLONTA'_MONDIALE_	[NGOITAMED] ;MleH 01 Jul 2010
ASSOCIAZIONE_VOLONTARI_PER_IL_SERVIZIO_INTERNATIONALE_	[NGOITA] ;MleH 01 Jul 2010
ATHGO_	[NGOUSA] ;MleH 01 Jul 2010
AUSTCARE_	[NGOAUSDEV]
AUTISM_SPEAKS_	[NGOHLH] ;MleH 01 Jul 2010
AVIATIONS_SANS_FRONTIERES_	[NGOEUR] ;MleH 01 Jul 2010
AVSI_	[NGOCHRCTHDEV]
BALM_IN_GILEAD_INC_	[NGOUSACHRPROHLH] ;MleH 01 Jul 2010
BAPTIST_WORLD_AID_	[NGOCHRPRODEV]
BARKA_FOUNDATION_	[NGOAFRDEV] ;MleH 01 Jul 2010
BATEY_RELIEF_ALLIANCE_	[NGOUSAHLH] ;MleH 01 Jul 2010
BPW_INTERNATIONAL_	[NGOBUS] ;MleH 01 Jul 2010
BPW_USA_	[NGOUSABUS] ;MleH 01 Jul 2010
BRAC_	[NGOBGDDEV]
BUILDING_AND_SOCIAL_HOUSING_FOUNDATION_	[NGOGBRDEV] ;MleH 01 Jul 2010
BUSINESS_AND_PROFESSIONAL_WOMEN_USA_	[NGOUSABUS] ;MleH 01 Jul 2010
BUSINESS_COUNCIL_FOR_INTERNATIONAL_UNDERSTANDING_	[NGOUSA] ;MleH 01 Jul 2010
C_SAFE_	[NGOSAF]
CADEF_	[NGOCMRDEV] ;MleH 01 Jul 2010
CAFOD_	[NGOGBRCHRCTHDEV]
CAMPAIGN_FOR_THE_EARTH_FOUNDATION_	[NGOENV] ;MleH 01 Jul 2010
CANADIAN_LUTHERAN_WORLD_RELIEF_	[NGOCANCHRPRODEV]
CAPAJ_	[NGOLAMHRI] ;MleH 01 Jul 2010
CATHOLIC_AGENCY_FOR_OVERSEAS_DEVELOPMENT_	[NGOGBRCHRCTHDEV]
CATHOLIC_CENTER_OF_CONCERN_	[NGOCHR]
CATHOLIC_INTERNATIONAL_EDUCATION_OFFICE_	[NGOCHRCTHEDU] ;MleH 01 Jul 2010
CATHOLIC_MEDICAL_MISSION_BOARD_	[NGOUSACHRCTHHLH]
CBM_INTERNATIONAL_	[NGOCHRHLH]
CCOMPOSA_	[NGOSAS]
CEAIE_	[NGOCHNEDU] ;MleH 01 Jul 2010
CEDPA_	[NGOUSA] ;MleH 01 Jul 2010
CEFIC_	[NGOEURBUS] ;MleH 01 Jul 2010
CENTER_FOR_DEMOCRACY_AND_RECONCILIATION_IN_SOUTHEAST_EUROPE_	[NGOEEU] ;MleH 01 Jul 2010
CENTER_FOR_DEVELOPMENT_AND_POPULATION_ACTIVITIES_	[NGOUSA] ;MleH 01 Jul 2010
CENTER_FOR_HUMANITARIAN_PSYCHOLOGY_	[NGOCHEHLH]
CENTER_FOR_INTERNATIONAL_HEALTH_AND_COOPERATION_	[NGO]
CENTRE_DE_RECHERCHES_ET_DE_PROMOTION_POUR_LA_SAUVEGARDE_DES_SITES_ET_MONUMENTS_HISTORIQUES_EN_AFRIQUE_	[NGOAFREDU] ;MleH 01 Jul 2010
CENTRE_EUROPE_TIERS_MONDE_	[NGODEV] ;MleH 01 Jul 2010
CENTRE_FOR_INTERNATIONAL_PEACEBUILDING_	[NGO] ;MleH 01 Jul 2010
CENTRE_FOR_PEACE_INITIATIVES_IN_AFRICA_	[NGOZWE] ;MleH 01 Jul 2010
CENTRO_DE_INVESTIGACION_PARA_LA_PAZ_	[NGOESP]
CENTRO_DI_RICERCA_E_DOCUMENTAZIONE_FEBBRAIO_74	[NGOITAEDU] ;MleH 01 Jul 2010
CESVI_	[NGOITADEV]
CFMSA_	[NGOUSACHRCTH] ;MleH 01 Jul 2010
CHERNOBYL_CHILDREN'S_PROJECT_	[NGOEEUHLH] ;MleH 01 Jul 2010
CHILD_FOUNDATION_	[NGOEDU] ;MleH 01 Jul 2010
CHILDFUND_	[NGO] ;MleH 01 Jul 2010
CHILDREN_INTERNATIONAL_	[NGODEV] ;MleH 01 Jul 2010
CHILDREN'S_FUND_FOR_SOUTHERN_AFRICA_	[NGOSAF] ;MleH 01 Jul 2010
CHINA_EDUCATION_ASSOCIATION_FOR_INTERNATIONAL_EXCHANGE_	[NGOCHNEDU] ;MleH 01 Jul 2010
CHINA_NGO_NETWORK_FOR_INTERNATIONAL_EXCHANGES_	[NGOCHN] ;MleH 01 Jul 2010
CHINA_YOUTH_DEVELOPMENT_FOUNDATION_	[NGOCHNEDU] ;MleH 01 Jul 2010
CHRISTIAN_CHILDREN'S_FUND_	[NGO] ;MleH 01 Jul 2010
CHRISTIAN_MISSION_FOR_THE_UNITED_NATIONS_COMMUNITY_	[NGOCHR] ;MleH 01 Jul 2010
CHRISTIAN_RELIEF_&_DEVELOPMENT_ASSOCATION_	[NGOETHCHRDEV]
CHRISTIAN_RELIEF_AND_DEVELOPMENT_ASSOCATION_	[NGOETHCHRDEV]
CHRISTIANS_ASSOCIATED_FOR_RELATIONSHIPS_WITH_EASTERN_EUROPE_	[NGOEEUCHR] ;MleH 01 Jul 2010
CHURCH_WORLD_SERVICE_	[NGOUSACHR] ;MleH 01 Jul 2010
CIDSE_	[NGOCHRCTHDEV] ;MleH 01 Jul 2010
CITIZENS_FOUNDATION,_THE_	[NGOPAKEDU] ;MleH 01 Jul 2010
CLEAN_UP_THE_WORLD_	[NGOAUSENV] ;MleH 01 Jul 2010
CLEAR_PATH_INTERNATIONAL_	[NGOHLH]
CMMB_	[NGOUSACHRCTHHLH]
CNIE_	[NGOCHN] ;MleH 01 Jul 2010
COALITION_AGAINST_TRAFFICKING_IN_WOMEN_	[NGO] ;MleH 01 Jul 2010
COALITION_FOR_PEACE_ACTION_	[NGOUSA] ;MleH 01 Jul 2010
CODEHUCA_	[NGOLAMHRI] ;MleH 01 Jul 2010
COLAC_	[NGOLAMBUS] ;MleH 01 Jul 2010
COMISION_JURIDICA_PARA_EL_AUTODESARROLLO_DE_LOS_PUEBLOS_ORIGINARIOS_ANDINOS_	[NGOLAMHRI] ;MleH 01 Jul 2010
COMITATO_COLLABORAZIONE_MEDICA_	[NGOITAHLH]
COMITE_EUROPEEN_DU_THE_	[NGOEURAGR] ;MleH 01 Jul 2010
COMITE_INTERNACIONAL_DE_LA_BANDERA_DE_LA_PAZ_	[NGO] ;MleH 01 Jul 2010
COMITE_NATIONAL_D'ACTION_POUR_LES_DROITS_DE_L'ENFANT_ET_DE_LA_FEMME_	[NGOCMRDEV] ;MleH 01 Jul 2010
COMMISSION_FOR_THE_DEFENSE_OF_HUMAN_RIGHTS_IN_CENTRAL_AMERICA_	[NGOLAMHRI] ;MleH 01 Jul 2010
COMMISSION_INTERNATIONALE_DE_L'ECLAIRAGE_	[NGOEDU] ;MleH 01 Jul 2010
COMMONWEALTH_BROADCASTING_ASSOCIATION_(CBA)	[NGOMED] ;MleH 01 Jul 2010
COMPANY_OF_THE_DAUGHTERS_OF_CHARITY_OF_ST._VINCENT_DE_PAUL_	[NGOCHRCTHDEV] ;MleH 01 Jul 2010
COMPUTERAID_	[NGODEV]
CONFEDERACION_LATINOAMERICANA_DE_COOPERATIVAS_DE_AHORRO_Y_CREDITO_	[NGOLAMBUS] ;MleH 01 Jul 2010
CONFERENCE_OF_NON_GOVERNMENTAL_ORGANIZATIONS_IN_CONSULTATIVE_RELATIONSHIP_WITH_THE_UNITED_NATIONS_	[NGO] ;MleH 01 Jul 2010
CONGRESS_OF_RACIAL_EQUALITY_	[NGOUSA] ;MleH 01 Jul 2010
CONSEJO_INDIO_DE_SUDAMERICA_	[NGOSAMHRI] ;MleH 01 Jul 2010
CONSORTIUM_FOR_THE_SOUTHERN_AFRICA_FOOD_SECURITY_EMERGENCY_	[NGOSAF]
COOPERATION_INTERNATIONALE_POUR_LE_DEVELOPMENT_ET_LA_SOLIDARITE_	[NGOCHRCTHDEV] ;MleH 01 Jul 2010
COOPERAZIONE_INTERNATIONALE_	[NGOITADEV] ;MleH 01 Jul 2010
COOPI_	[NGOITADEV] ;MleH 01 Jul 2010
COORDINATING_BOARD_OF_JEWISH_ORGANIZATIONS_	[NGOJEW] ;MleH 01 Jul 2010
COORDINATION_COMMITTEE_OF_MAOIST_PARTIES_AND_ORGANISATIONS_IN_SOUTH_ASIA_	[NGOSAS]; NGO_Actors
CORDAID_	[NGONLD]
CORNELIO_SOMMARUGA_	[NGOHLHIRC 870507-991231]	; Red Cross and Red Crescent
COUSTEAU_SOCIETY_	[NGOENV] ;MleH 01 Jul 2010
CROATIAN_CLUB_FOR_INTERNATIONAL_COOPERATION_	[NGOHRV] ;MleH 01 Jul 2010
CROIX_ROUGE_	[NGOHLHIRC]
CRUZ_ROJA_	[NGOHLHIRC]
CULTURAL_SURVIVAL,_INC.	[NGOLAMHRI]; NGO_Actors
CULTURAL_SURVIVAL_INC.	[NGOLAMHRI] ;MleH 01 Jul 2010
CYDF_	[NGOCHNEDU] ;MleH 01 Jul 2010
DANCHURCHAID_	[NGODNKCHRPRO]
DANIEL_PEARL_FOUNDATION_	[NGOUSAMED] ;MleH 01 Jul 2010
DANISH_AFGHAN_COMMITTEE_	[NGODNKHLH]
DANISH_REFUGEE_COUNCIL_	[NGODNKREF]
DAVID_MCANTONY_GIBSON_FOUNDATION_	[NGOCANHLH]
DELTA_KAPPA_GAMMA_	[NGOUSAEDU] ;MleH 01 Jul 2010
DELTA_SIGMA_THETA_	[NGOUSAEDU] ;MleH 01 Jul 2010
DEMOCRACY_COALITION_PROJECT_	[NGODEV] ;MleH 01 Jul 2010
DEUTSCHE_WELTHUNGERHILFE_	[NGODEUAGR]
DEVELOPING_COUNTRIES_FARM_RADIO_NETWORK_	[NGOCANMEDAGR] ;MleH 01 Jul 2010
DEVELOPMENT_ALTERNATIVES_WITH_WOMEN_FOR_A_NEW_ERA_	[NGODEV]
DEVELOPMENT_STUDIES_ASSOCIATION_	[NGOGBREDUDEV] ;MleH 01 Jul 2010
DEVNET_ASSOCIATION_	[NGOROMBUS] ;MleH 01 Jul 2010
DHAKA_AHSANIA_MISSION_	[NGOSASMOSDEV] ;MleH 01 Jul 2010
DIAKONIE_KATASTROPHENHILFE_	[NGODEU]
DISASTER_PSYCHIATRY_OUTREACH_	[NGOUSAHLH] ;MleH 01 Jul 2010
DISASTERS_EMERGENCY_COMMITTEE_	[NGOGBR]
DOCTORS_OF_THE_WORLD_USA_	[NGOUSAHLH]
DORCAS_AID_	[NGOCHRDEV]
DROITS_A_L'ENERGIE_SOS_FUTURE_	[NGOFRAENV] ;MleH 01 Jul 2010
DVV_INTERNATIONAL_	[NGODEUEDU] ;MleH 01 Jul 2010
EARTH_CHILD_INSTITUTE_	[NGO] ;MleH 01 Jul 2010
EARTHJUSTICE_	[NGOUSAENV] ;MleH 01 Jul 2010
EARTHTRUST_	[NGOENV] ;MleH 01 Jul 2010
EASTERN_REGIONAL_ORGANIZATION_FOR_PUBLIC_ADMINISTRATION_	[NGOASADEV] ;MleH 01 Jul 2010
ECCP_	[NGOEUR] ;MleH 01 Jul 2010
ECONEWS_AFRICA_	[NGOAFRENV] ;MleH 01 Jul 2010
ECONOMISTS_FOR_PEACE_AND_SECURITY_	[NGO] ;MleH 01 Jul 2010
ECOWAS_YOUTH_AND_CITIZENS_LEAGUE_	[NGOWAFBUSWAS] ;MleH 01 Jul 2010
ECPAT_	[NGOHRI] ;MleH 01 Jul 2010
EDUCATION_DEVELOPMENT_CENTER_	[NGOUSAEDU] ;MleH 01 Jul 2010
ELIZABETH_HAUB_FOUNDATION_	[NGOENV] ;MleH 01 Jul 2010
EMERGENCY_LIFE_SUPPORT_FOR_CIVILIAN_WAR_VICTIMS_	[NGOITAHLH] ;MleH 01 Jul 2010
ENGLISH_INTERNATIONAL_ASSOCIATION_OF_LUND_	[NGOSWELAB] ;MleH 01 Jul 2010
ENVIRONMENTAL_DEVELOPMENT_ACTION_IN_THE_THIRD_WORLD_	[NGOSENDEV] ;MleH 01 Jul 2010
ENVIRONMENTAL_LAW_INSTITUTE_	[NGOUSAENV] ;MleH 01 Jul 2010
EQUIPE_COUSTEAU_	[NGOFRAENV] ;MleH 01 Jul 2010
ESTONIAN_AMERICAN_FUND_FOR_ECONOMIC_EDUCATION_	[NGOESTDEV]; NGO_Actors
EUROPEAN_ACADEMY_OF_ARTS,_SCIENCES_AND_HUMANITIES_	[NGOEUREDU] ;MleH 01 Jul 2010
EUROPEAN_CENTRE_FOR_CONFLICT_PREVENTION_	[NGOEUR] ;MleH 01 Jul 2010
EUROPEAN_CHEMICAL_INDUSTRY_COUNCIL_	[NGOEURBUS] ;MleH 01 Jul 2010
EUROPEAN_STUDENTS_FORUM_	[NGOEUREDU] ;MleH 01 Jul 2010
EUROPEAN_WIND_ENERGY_ASSOCIATION_	[NGOEURBUSENV] ;MleH 01 Jul 2010
EVERYCHILD_	[NGODEV]
EXPLORERS_CLUB_	[NGOUSAEDU] ;MleH 01 Jul 2010
FAWCO_	[NGOUSA] ;MleH 01 Jul 2010
FDI_WORLD_DENTAL_FEDERATION_	[NGOHLH] ;MleH 01 Jul 2010
FEDERACION_DE_MUJERES_PROGRESISTAS_	[NGOESPHRI] ;MleH 01 Jul 2010
FEDERATION_FOR_PEACE_AND_CONCILIATION_	[NGORUS] ;MleH 01 Jul 2010
FEDERATION_INTERNATIONALE_DES_CORPS_ET_ASSOCIATIONS_CONSULAIRES_	[NGO] ;MleH 01 Jul 2010
FEDERATION_INTERNATIONALE_DES_DROITS_DE_L'HOMME_	[NGOHRI] ;MleH 01 Jul 2010
FEDERATION_INTERNATIONALE_DES_FEMMES_DES_CARRIERES_JURIDIQUES_	[NGOJUDHRI] ;MleH 01 Jul 2010
FEDERATION_INTERNATIONALE_DES_ORGANISATIONS_DE_CORRESPONDANCE_ET_D'ECHANGES_SCOLAIRES_	[NGOEDU] ;MleH 01 Jul 2010
FEDERATION_OF_ASSOCIATIONS_OF_FORMER_INTERNATIONAL_CIVIL_SERVANTS_	[NGO] ;MleH 01 Jul 2010
FEDERATION_OF_EUROPEAN_TWINE_AND_ROPE_INDUSTRIES_	[NGOEURBUS] ;MleH 01 Jul 2010
FEDERATION_OF_JEWISH_MEN'S_CLUBS_	[NGONMRJEW] ;MleH 01 Jul 2010
FEDERATION_OF_WORLD_VOLUNTEER_FIREFIGHTERS_ASSOCIATIONS_	[NGO] ;MleH 01 Jul 2010
FEMMES_AFRIQUE_SOLIDARITE_	[NGOAFR] ;MleH 01 Jul 2010
FEREMA_	[NGOHNDEDU] ;MleH 01 Jul 2010
FH_ASSOCIATION_	[NGOCHRPRO]
FHEDA_	[NGOPHLHLH] ;MleH 01 Jul 2010
FIABCI_	[NGOBUS] ;MleH 01 Jul 2010
FIANAKAVIANA_SAMBRATRA_	[NGOMDGHLH] ;MleH 01 Jul 2010
FIMITIC_	[NGOEURHRI] ;MleH 01 Jul 2010
FINN_CHURCH_AID_	[NGOFINCHR]
FINNCHURCHAID_	[NGOFINCHR]
FIRST_WEEK_FOUNDATION_	[NGONOR] ;MleH 01 Jul 2010
FONDATION_HIRONDELLE_	[NGOMED]
FOOD_FOR_THE_HUNGRY_ASSOCIATION_	[NGOCHRPRO]
FOOD_FOR_THE_HUNGRY_INTERNATIONAL_	[NGOCHRPRO] ;MleH 01 Jul 2010
FORD_FOUNDATION_	[NGOUSA] ;MleH 01 Jul 2010
FOREIGNAID_500_	[NGODEV]; NGO_Actors
FOREST_TREES_AND_PEOPLE_PROGRAM_	[NGOENV]; NGO_Actors
FORMERLY_UNITED_CHURCH_BOARD_FOR_WORLD_MINISTRIES_	[NGOCHRPRO] ;MleH 01 Jul 2010
FORUM_FOR_AFRICAN_WOMEN_EDUCATIONALISTS_	[NGOAFREDU] ;MleH 01 Jul 2010
FORUM_ON_EARLY_WARNING_AND_EARLY_RESPONSE_	[NGO]
FOUNDATION_ECOLOGY_AND_LIFE_	[NGOENV] ;MleH 01 Jul 2010
FOUNDATION_FOR_AMITY_AND_NATIONAL_SOLIDARITY_	[NGOIND] ;MleH 01 Jul 2010
FOUNDATION_FOR_HEALTH_EDUCATION_AND_DRUG_AWARENESS_	[NGOPHLHLH] ;MleH 01 Jul 2010
FOUNDATION_FOR_POST_CONFLICT_DEVELOPMENT_	[NGOUSADEV] ;MleH 01 Jul 2010
FOUNDATION_FOR_SUBJECTIVE_EXPERIENCE_AND_RESEARCH_	[NGODEUREL] ;MleH 01 Jul 2010
FOUNDATION_FOR_THE_RIGHTS_OF_THE_FAMILY_	[NGOESP] ;MleH 01 Jul 2010
FRIENDSHIP_AMBASSADORS_FOUNDATION_	[NGOMED] ;MleH 01 Jul 2010
FULBRIGHT_ASSOCIATION_	[NGOUSAEDU] ;MleH 01 Jul 2010
FUNDACAO_DE_ASSISTENCIA_MEDICA_INTERNACIONAL_	[NGOPRT] ;MleH 01 Jul 2010
FUNDACION_CULTURAL_BAUR_	[NGODEV] ;MleH 01 Jul 2010
FUNDACION_GLOBAL_DEMOCRACIA_Y_DESARROLLO_	[NGODOM] ;MleH 01 Jul 2010
FUNDACION_NUEVO_MILENIO_	[NGOARG] ;MleH 01 Jul 2010
FUNDACION_PARA_LA_EDUCACION_RICARDO_ERNESTO_MADURO_ANDREU_	[NGOHNDEDU] ;MleH 01 Jul 2010
FUNDACION_SALVEMOS_EL_AGUA_	[NGOMEXENV] ;MleH 01 Jul 2010
FUNGLODE_	[NGODOM] ;MleH 01 Jul 2010
FUSEN_HEISHI_NO_KAI_	[NGOVNM] ;MleH 01 Jul 2010
GADDAFI_INTERNATIONAL_CHARITY_AND_DEVELOPMENT_FOUNDATION_	[NGOLBY] ;MleH 01 Jul 2010
GENDER_WATCHERS_	[NGO] ;MleH 01 Jul 2010
GENERAL_CONFEDERATION_OF_TRADE_UNIONS_	[NGOCASLAB] ;MleH 01 Jul 2010
GIRLS_LEARN_INTERNATIONAL_	[NGOUSAEDU] ;MleH 01 Jul 2010
GLOBAL_ACTION_ON_AGEING_	[NGO] ;MleH 01 Jul 2010
GLOBAL_ACTION_ON_AGING_	[NGO] ;MleH 01 Jul 2010
GLOBAL_ALLIANCE_FOR_PUBLIC_RELATIONS_AND_COMMUNICATION_MANAGEMENT_	[NGOBUSMED] ;MleH 01 Jul 2010
GLOBAL_EDUCATION_MOTIVATORS_	[NGOEDU] ;MleH 01 Jul 2010
GLOBAL_FAMILY_FOR_LOVE_AND_PEACE_	[NGOTAO] ;MleH 01 Jul 2010
GLOBAL_FOUNDATION_FOR_DEMOCRACY_AND_DEVELOPMENT_	[NGODOM] ;MleH 01 Jul 2010
GLOBAL_FUND_FOR_HIV_AIDS_	[NGOHLH]
GLOBAL_HEALTH_ACTION_	[NGOEURHLH] ;MleH 01 Jul 2010
GLOBAL_INFORMATION_NETWORK_	[NGOAFRMED] ;MleH 01 Jul 2010
GLOBAL_KIDS,_INC_	[NGOUSA] ;MleH 01 Jul 2010
GLOBAL_KIDS_INC_	[NGOUSA] ;MleH 01 Jul 2010
GLOBAL_NETWORK_AGAINST_WEAPONS_AND_NUCLEAR_POWER_IN_SPACE_	[NGOUSA] ;MleH 01 Jul 2010
GLOBAL_SECURITY_INSTITUTE_	[NGOUSA] ;MleH 01 Jul 2010
GLOBAL_VISION_FOR_PEACE_	[NGOUSAMED] ;MleH 01 Jul 2010
GLOBAL_YOUTH_ACTION_NETWORK_	[NGO] ;MleH 01 Jul 2010
GLOBETREE_	[NGO] ;MleH 01 Jul 2010
GOOD_NEIGHBOURS_INTERNATIONAL_	[NGODEV]
GOOD_NEWS_AGENCY_	[NGOITAMED] ;MleH 01 Jul 2010
GRASSROOTS_ORGANIZATIONS_OPERATING_TOGETHER_IN_SISTERHOOD_	[NGO] ;MleH 01 Jul 2010
GROOTS_INTERNATIONAL_	[NGO] ;MleH 01 Jul 2010
HABITAT_FOR_HUMANITY_	[NGOCHR]
HABITAT_POUR_L'HUMANITE_	[NGOCHR]
HAGUE_APPEAL_FOR_PEACE_	[NGO] ;MleH 01 Jul 2010
HAGUE_INTERNATIONAL_MODEL_UNITED_NATIONS_	[NGOEDU] ;MleH 01 Jul 2010
HAP_INTERNATIONAL_	[NGO]
HARVARD_HUMAN_RIGHTS_INTERNET_	[NGOUSAHRI]
HATOF_FOUNDATION_	[NGOGHADEV] ;MleH 01 Jul 2010
HEADINGTON_INSTITUTE_	[NGOUSAHLH] ;MleH 01 Jul 2010
HEALTH_CARE_ORGANIZATION_FOR_AFRICA_	[NGOAFRHLH] ;MleH 01 Jul 2010
HEALTH_PARTNERS_INTERNATIONAL_	[NGOHLH]
HEALTH_POVERTY_ACTION_	[NGOGBRHLH]
HEALTHNET_TPO_	[NGONLDHLH]
HEALTHRIGHT_	[NGOHRIHLH]
HEARTLAND_ALLIANCE_FOR_HUMAN_NEEDS_AND_HUMAN_RIGHTS_	[NGOUSAHRI] ;MleH 01 Jul 2010
HELEN_KELLER_INTERNATIONAL_	[NGOHLH] ;MleH 01 Jul 2010
HELFEN_WIR_	[NGOAUTDEV]
HELPAGE_INTERNATIONAL_	[NGOHRI] ;MleH 01 Jul 2010
HEPCA_	[NGOMDEENV] ;MleH 01 Jul 2010
HILFE_ZUR_SELBSTHILFE_	[NGODEU]
HOPE_'87_	[NGOAUT] ;MleH 01 Jul 2010
HORN_RELIEF_	[NGOSOMDEV]
HUMAN_RIGHTS_ADVOCATES_INC.	[NGOUSAHRI] ;MleH 01 Jul 2010
HUMANISTIC_INSTITUTE_FOR_CO_OPERATION_WITH_DEVELOPING_COUNTRIES_	[NGONLDDEV] ;MleH 01 Jul 2010
HUMANITARIAN_ACCOUNTABILITY_PARTNERSHIP_	[NGO]
HUMEDICA_	[NGODEU]
HUMPTY_DUMPTY_INSTITUTE_	[NGOUSA] ;MleH 01 Jul 2010
HUNGARIAN_INTERCHURCH_AID_	[NGOHUNCHR]	; ecumenical, includes all different types of Christian
HURGHADA_ENVIRONMENTAL_PROTECTION_AND_CONSERVATION_ORGANIZATION_	[NGOMDEENV] ;MleH 01 Jul 2010
I.D.E.A.L._SOCIETY_	[NGOCANEDU] ;MleH 01 Jul 2010
IAAP_	[NGOEDU] ;MleH 01 Jul 2010
IABSE_	[NGOBUS] ;MleH 01 Jul 2010
IAJ_UIM_	[NGOJUD] ;MleH 01 Jul 2010
IAMANEH_	[NGOHLH] ;MleH 01 Jul 2010
IANSA_	[NGO] ;MleH 01 Jul 2010
ICAI_	[NGODEV] ;MleH 01 Jul 2010
ICDDR,B_	[NGOBGDHLH]
ICDDRB_	[NGOBGDHLH]
ICMEC_	[NGOUSA] ;MleH 01 Jul 2010
ICMICA_IMCS_	[NGOCHRCTHEDU] ;MleH 01 Jul 2010
ICOMP_	[NGODEV] ;MleH 01 Jul 2010
ICTUR_	[NGOLABHRI] ;MleH 01 Jul 2010
ICVOLUNTEERS_	[NGOMED] ;MleH 01 Jul 2010
IFFAMPAC_	[NGO] ;MleH 01 Jul 2010
IFLRY_	[NGOPTY] ;MleH 01 Jul 2010
IFMBE_	[NGOHLH] ;MleH 01 Jul 2010
IHEAS_	[NGORUSEDU] ;MleH 01 Jul 2010
IMAMIA_MEDICS_INTERNATIONAL_	[NGOMOSHLH] ;MleH 01 Jul 2010
INDIAN_COUNCIL_OF_SOUTH_AMERICA_	[NGOSAMHRI] ;MleH 01 Jul 2010
INDIAN_LAW_RESOURCE_CENTER_	[NGOUSA] ;MleH 01 Jul 2010
INFORMATION_TECHNOLOGIES_FOR_DEVELOPMENT_	[NGODEVMED] ;MleH 01 Jul 2010
INFOTERM_	[NGO] ;MleH 01 Jul 2010
INITIATIVES_OF_CHANGE_INTERNATIONAL_	[NGO] ;MleH 01 Jul 2010
INPEA_	[NGOHRI] ;MleH 01 Jul 2010
INSTITUT_INTERNATIONAL_DES_SCIENCES_HUMAIN_INTEGRALES_	[NGOREL] ;MleH 01 Jul 2010
INSTITUTE_FOR_INTERRELIGIOUS_DIALOGUE_	[NGOIRNREL] ;MleH 01 Jul 2010
INSTITUTE_FOR_THE_DEVELOPMENT_OF_EDUCATION_ARTS_AND_LEISURE_	[NGOCANEDU] ;MleH 01 Jul 2010
INSTITUTE_OF_CULTURAL_AFFAIRS_INTERNATIONAL_	[NGODEV] ;MleH 01 Jul 2010
INSTITUTE_OF_GENERAL_SEMANTICS_	[NGOUSAEDU] ;MleH 01 Jul 2010
INSTITUTE_OF_INTERNAL_AUDITORS_	[NGOBUS] ;MleH 01 Jul 2010
INSTITUTE_OF_INTERNATIONAL_EDUCATION_	[NGOEDU] ;MleH 01 Jul 2010
INSTITUTO_DE_ESTUDOS_PARA_O_DESENVOLVIMENTO_	[NGOPRTDEV] ;MleH 01 Jul 2010
INSTITUTO_GRISELDA_ALVAREZ_	[NGOMEXDEV] ;MleH 01 Jul 2010
INSTITUTO_IBEROAMERICANO_DE_DERECHO_AERONAUTICO_Y_DEL_ESPACIO_Y_DE_LA_AVIACION_COMERCIAL_	[NGOLAMBUS] ;MleH 01 Jul 2010
INSULA_	[NGODEV] ;MleH 01 Jul 2010
INTER_AMERICAN_HOUSING_UNION_	[NGOLAMDEV] ;MleH 01 Jul 2010
INTER_AMERICAN_PRESS_ASSOCIATION_	[NGOWSTMED] ;MleH 01 Jul 2010
INTER_PRESS_SERVICE_	[NGOMED] ;MleH 01 Jul 2010
INTERACTION:_AMERICAN_COUNCIL_FOR_VOLUNTARY_INTERNATIONAL_ACTION_	[NGOUSA] ;MleH 01 Jul 2010
INTERFAITH_CENTER_ON_CORPORATE_RESPONSIBILITY_	[NGOUSACHRBUS] ;MleH 01 Jul 2010
INTERFAITH_CENTRE_OF_NEW_YORK_	[NGOUSAREL] ;MleH 01 Jul 2010
INTERMON_	[NGOXFM]
INTERNATIONAL_ABOLITIONIST_FEDERATION_	[NGOHRI] ;MleH 01 Jul 2010
INTERNATIONAL_ACTION_NETWORK_ON_SMALL_ARMS_	[NGO] ;MleH 01 Jul 2010
INTERNATIONAL_ADVERTISING_ASSOCIATION_	[NGOBUSMED] ;MleH 01 Jul 2010
INTERNATIONAL_AGENCY_FOR_THE_PREVENTION_OF_BLINDNESS_	[NGOHLH] ;MleH 01 Jul 2010
INTERNATIONAL_ASSOCIATION_AGAINST_DRUG_TRAFFICKING_AND_DRUG_ABUSE_	[NGORUSHLH] ;MleH 01 Jul 2010
INTERNATIONAL_ASSOCIATION_AGAINST_NOISE_	[NGOEURENV] ;MleH 01 Jul 2010
INTERNATIONAL_ASSOCIATION_AGAINST_PAINFUL_EXPERIMENTS_ON_ANIMALS_	[NGOENV] ;MleH 01 Jul 2010
INTERNATIONAL_ASSOCIATION_FOR_BRIDGE_AND_STRUCTURAL_ENGINEERING_	[NGOBUS] ;MleH 01 Jul 2010
INTERNATIONAL_ASSOCIATION_FOR_COMMUNITY_DEVELOPMENT_	[NGODEV] ;MleH 01 Jul 2010
INTERNATIONAL_ASSOCIATION_FOR_HOUSING_SCIENCE_	[NGOEDU] ;MleH 01 Jul 2010
INTERNATIONAL_ASSOCIATION_FOR_MATERNAL_AND_NEONATAL_HEALTH_	[NGOHLH] ;MleH 01 Jul 2010
INTERNATIONAL_ASSOCIATION_FOR_RESEARCH_IN_INCOME_AND_WEALTH_	[NGOEDUBUS] ;MleH 01 Jul 2010
INTERNATIONAL_ASSOCIATION_FOR_THE_EXCHANGE_OF_STUDENTS_FOR_TECHNICAL_EXPERIENCE_	[NGOEDU] ;MleH 01 Jul 2010
INTERNATIONAL_ASSOCIATION_FOR_VOLUNTEER_EFFORT_	[NGO] ;MleH 01 Jul 2010
INTERNATIONAL_ASSOCIATION_FOR_WATER_LAW_	[NGOENV] ;MleH 01 Jul 2010
INTERNATIONAL_ASSOCIATION_OF_APPLIED_PSYCHOLOGY_	[NGOEDU] ;MleH 01 Jul 2010
INTERNATIONAL_ASSOCIATION_OF_CRAFTS_&_SMALL_&_MEDIUM_SIZED_ENTERPRISES_	[NGOBUS] ;MleH 01 Jul 2010
INTERNATIONAL_ASSOCIATION_OF_CRAFTS_AND_SMALL_AND_MEDIUM_SIZED_ENTERPRISES_	[NGOBUS] ;MleH 01 Jul 2010
INTERNATIONAL_ASSOCIATION_OF_DEMOCRATIC_LAWYERS_	[NGOJUD] ;MleH 01 Jul 2010
INTERNATIONAL_ASSOCIATION_OF_DRILLING_CONTRACTORS_	[NGOBUS] ;MleH 01 Jul 2010
INTERNATIONAL_ASSOCIATION_OF_GERONTOLOGY_	[NGOEDU] ;MleH 01 Jul 2010
INTERNATIONAL_ASSOCIATION_OF_INDEPENDENT_TANKER_OWNERS_	[NGOBUS] ;MleH 01 Jul 2010
INTERNATIONAL_ASSOCIATION_OF_JEWISH_LAWYERS_AND_JURISTS_	[NGOJEWJUDHRI] ;MleH 01 Jul 2010
INTERNATIONAL_ASSOCIATION_OF_JUDGES_	[NGOJUD] ;MleH 01 Jul 2010
INTERNATIONAL_ASSOCIATION_OF_LAWYERS_AGAINST_NUCLEAR_ARMS_	[NGO] ;MleH 01 Jul 2010
INTERNATIONAL_ASSOCIATION_OF_LIONS_CLUBS_	[NGO] ;MleH 01 Jul 2010
INTERNATIONAL_ASSOCIATION_OF_LOGOPEDICS_AND_PHONIATRICS_	[NGOEDU] ;MleH 01 Jul 2010
INTERNATIONAL_ASSOCIATION_OF_OIL_AND_GAS_PRODUCERS_	[NGOBUS] ;MleH 01 Jul 2010
INTERNATIONAL_ASSOCIATION_OF_PEACE_FOUNDATIONS_	[NGOCAS] ;MleH 01 Jul 2010
INTERNATIONAL_ASSOCIATION_OF_PORTS_AND_HARBORS_	[NGOBUS] ;MleH 01 Jul 2010
INTERNATIONAL_ASSOCIATION_OF_SCHOOLS_OF_SOCIAL_WORK_	[NGOEDU] ;MleH 01 Jul 2010
INTERNATIONAL_ASSOCIATION_OF_UNIVERSITY_PRESIDENTS_	[NGOEDU] ;MleH 01 Jul 2010
INTERNATIONAL_ASSOCIATION_OF_WOMEN_IN_RADIO_AND_TELEVISION_	[NGOMED] ;MleH 01 Jul 2010
INTERNATIONAL_ASSOCIATION_OF_WOMEN_JUDGES_	[NGOJUD] ;MleH 01 Jul 2010
INTERNATIONAL_ASSOCIATION_OF_YOUNG_LAWYERS_	[NGOJUD] ;MleH 01 Jul 2010
INTERNATIONAL_ASTRONAUTICAL_FEDERATION_	[NGOEDU] ;MleH 01 Jul 2010
INTERNATIONAL_BAR_ASSOCIATION_	[NGOJUDHRI] ;MleH 01 Jul 2010
INTERNATIONAL_BLUE_CRESCENT_	[NGOTURDEV] ;MleH 01 Jul 2010
INTERNATIONAL_BOARD_ON_BOOKS_FOR_YOUNG_PEOPLE_	[NGOEDU] ;MleH 01 Jul 2010
INTERNATIONAL_BOOK_BANK_	[NGOEDU]; NGO_Actors
INTERNATIONAL_BOOK_PROJECT,_INC.	[NGOEDU]	; NGO_Actors
INTERNATIONAL_BOOK_PROJECT_	[NGOEDU]; NGO_Actors
INTERNATIONAL_CARTOGRAPHIC_ASSOCIATION_	[NGOEDU] ;MleH 01 Jul 2010
INTERNATIONAL_CATHOLIC_CHILD_BUREAU_	[NGOCHRCTHHRI] ;MleH 01 Jul 2010
INTERNATIONAL_CATHOLIC_UNION_OF_THE_PRESS_	[NGOCHRCTHMED] ;MleH 01 Jul 2010
INTERNATIONAL_CENTRE_FOR_MISSING_AND_EXPLOITED_CHILDREN_	[NGOUSA] ;MleH 01 Jul 2010
INTERNATIONAL_CENTRE_FOR_TRADE_UNION_RIGHTS_	[NGOLABHRI] ;MleH 01 Jul 2010
INTERNATIONAL_CENTRE_OF_ROERICHS_	[NGORUS] ;MleH 01 Jul 2010
INTERNATIONAL_CO_OPERATIVE_ALLIANCE_	[NGOBUS] ;MleH 01 Jul 2010
INTERNATIONAL_COMMISSION_ON_IRRIGATION_&_DRAINAGE_	[NGOAGR] ;MleH 01 Jul 2010
INTERNATIONAL_COMMISSION_ON_IRRIGATION_AND_DRAINAGE_	[NGOAGR] ;MleH 01 Jul 2010
INTERNATIONAL_COMMISSION_ON_OCCUPATIONAL_HEALTH_	[NGOBUS] ;MleH 01 Jul 2010
INTERNATIONAL_COMMUNICATION_ASSOCIATION_	[NGOEDU] ;MleH 01 Jul 2010
INTERNATIONAL_CONFEDERATION_OF_MIDWIVES_	[NGOHLH] ;MleH 01 Jul 2010
INTERNATIONAL_CONFERENCE_OF_LABOUR_HISTORIANS_	[NGOEDULAB] ;MleH 01 Jul 2010
INTERNATIONAL_COOPERATIVE_ALLIANCE_	[NGOBUS] ;MleH 01 Jul 2010
INTERNATIONAL_COUNCIL_FOR_ADULT_EDUCATION_	[NGOEDU] ;MleH 01 Jul 2010
INTERNATIONAL_COUNCIL_FOR_CARING_COMMUNITIES_	[NGO] ;MleH 01 Jul 2010
INTERNATIONAL_COUNCIL_FOR_COMMERCIAL_ARBITRATION_	[NGOBUS] ;MleH 01 Jul 2010
INTERNATIONAL_COUNCIL_FOR_SCIENCE_	[NGOEDU] ;MleH 01 Jul 2010
INTERNATIONAL_COUNCIL_OF_MUSEUMS_	[NGOEDU] ;MleH 01 Jul 2010
INTERNATIONAL_COUNCIL_OF_NURSES_	[NGOHLH] ;MleH 01 Jul 2010
INTERNATIONAL_COUNCIL_OF_PSYCHOLOGISTS_	[NGOEDU] ;MleH 01 Jul 2010
INTERNATIONAL_COUNCIL_OF_WOMEN_	[NGO] ;MleH 01 Jul 2010
INTERNATIONAL_COUNCIL_ON_ALCOHOL_AND_ADDICTIONS_	[NGOHLH] ;MleH 01 Jul 2010
INTERNATIONAL_COUNCIL_ON_EDUCATION_FOR_TEACHING_	[NGOEDU] ;MleH 01 Jul 2010
INTERNATIONAL_COUNCIL_ON_MANAGEMENT_OF_POPULATION_PROGRAMMES_	[NGODEV] ;MleH 01 Jul 2010
INTERNATIONAL_COUNCIL_ON_SOCIAL_WELFARE_	[NGODEV] ;MleH 01 Jul 2010
INTERNATIONAL_DESALINATION_ASSOCIATION_	[NGODEV] ;MleH 01 Jul 2010
INTERNATIONAL_DIABETES_FEDERATION_	[NGOHLH] ;MleH 01 Jul 2010
INTERNATIONAL_ELECTROTECHNICAL_COMMITTEE_	[NGOBUS] ;MleH 01 Jul 2010
INTERNATIONAL_FEDERATION_FOR_EAST_TIMOR_	[NGOTMP] ;MleH 01 Jul 2010
INTERNATIONAL_FEDERATION_FOR_HOME_ECONOMICS_	[NGO] ;MleH 01 Jul 2010
INTERNATIONAL_FEDERATION_FOR_HOUSING_AND_PLANNING_	[NGOBUS] ;MleH 01 Jul 2010
INTERNATIONAL_FEDERATION_FOR_MEDICAL_&_BIOLOGICAL_ENGINEERING_	[NGOHLH] ;MleH 01 Jul 2010
INTERNATIONAL_FEDERATION_OF_AGRICULTURAL_PRODUCERS_	[NGOAGR] ;MleH 01 Jul 2010
INTERNATIONAL_FEDERATION_OF_ASSOCIATIONS_OF_THE_ELDERLY_	[NGO] ;MleH 01 Jul 2010
INTERNATIONAL_FEDERATION_OF_AUTOMATIC_CONTROL_	[NGOBUS] ;MleH 01 Jul 2010
INTERNATIONAL_FEDERATION_OF_BEEKEEPERS'_ASSOCIATIONS_	[NGOAGR] ;MleH 01 Jul 2010
INTERNATIONAL_FEDERATION_OF_BUSINESS_AND_PROFESSIONAL_WOMEN_	[NGOBUS] ;MleH 01 Jul 2010
INTERNATIONAL_FEDERATION_OF_CATHOLIC_UNIVERSITIES_	[NGOCHRCTHEDU] ;MleH 01 Jul 2010
INTERNATIONAL_FEDERATION_OF_CLINICAL_CHEMISTRY_	[NGOHLH] ;MleH 01 Jul 2010
INTERNATIONAL_FEDERATION_OF_EMPLOYEES_IN_PUBLIC_SERVICES_	[NGOLAB] ;MleH 01 Jul 2010
INTERNATIONAL_FEDERATION_OF_FAMILY_ASSOCIATIONS_OF_MISSING_PERSONS_FROM_ARMED_CONFLICTS_	[NGO] ;MleH 01 Jul 2010
INTERNATIONAL_FEDERATION_OF_FREIGHT_FORWARDERS_ASSOCIATIONS_	[NGOBUS] ;MleH 01 Jul 2010
INTERNATIONAL_FEDERATION_OF_LIBERAL_YOUTH_	[NGOPTY] ;MleH 01 Jul 2010
INTERNATIONAL_FEDERATION_OF_MEDICAL_AND_BIOLOGICAL_ENGINEERING_	[NGOHLH] ;MleH 01 Jul 2010
INTERNATIONAL_FEDERATION_OF_MEDICAL_STUDENTS'_ASSOCIATIONS_	[NGOEDUHLH] ;MleH 01 Jul 2010
INTERNATIONAL_FEDERATION_OF_PERSONS_WITH_PHYSICAL_DISABILITY_	[NGOEURHRI] ;MleH 01 Jul 2010
INTERNATIONAL_FEDERATION_OF_PHARMACEUTICAL_MANUFACTURERS_ASSOCIATIONS_(IFPMA)	[NGOHLH] ;MleH 01 Jul 2010
INTERNATIONAL_FEDERATION_OF_SETTLEMENTS_AND_NEIGHBOURHOOD_CENTRES_	[NGO] ;MleH 01 Jul 2010
INTERNATIONAL_FEDERATION_OF_SOCIAL_WORKERS_	[NGOBUS] ;MleH 01 Jul 2010
INTERNATIONAL_FEDERATION_OF_SURGICAL_COLLEGES_	[NGOEDUHLH] ;MleH 01 Jul 2010
INTERNATIONAL_FEDERATION_OF_SURVEYORS_	[NGOBUS] ;MleH 01 Jul 2010
INTERNATIONAL_FEDERATION_OF_TRAINING_AND_DEVELOPMENT_ORGANIZATIONS_	[NGOEDUDEV] ;MleH 01 Jul 2010
INTERNATIONAL_FEDERATION_OF_WOMEN_IN_LEGAL_CAREERS_	[NGOJUDHRI] ;MleH 01 Jul 2010
INTERNATIONAL_FEDERATION_OF_WOMEN_LAWYERS_	[NGOJUD] ;MleH 01 Jul 2010
INTERNATIONAL_FEDERATION_OF_WORKERS'_EDUCATIONAL_ASSOCIATIONS_	[NGOZAFEDU] ;MleH 01 Jul 2010
INTERNATIONAL_FEDERATION_ON_AGEING_	[NGO] ;MleH 01 Jul 2010
INTERNATIONAL_FELLOWSHIP_OF_RECONCILIATION_	[NGOCHRPRO] ;MleH 01 Jul 2010
INTERNATIONAL_FILM_AND_TELEVISION_EXCHANGE_	[NGOUSAMED] ;MleH 01 Jul 2010
INTERNATIONAL_FORUM_FOR_CHILD_WELFARE_	[NGO] ;MleH 01 Jul 2010
INTERNATIONAL_GENDER_ORGANIZATION_	[NGO] ;MleH 01 Jul 2010
INTERNATIONAL_HEALTH_AWARENESS_NETWORK_	[NGOHLH] ;MleH 01 Jul 2010
INTERNATIONAL_HIGHER_EDUCATION_ACADEMY_OF_SCIENCES_	[NGORUSEDU] ;MleH 01 Jul 2010
INTERNATIONAL_HIV_AIDS_ALLIANCE_	[NGOHLH]
INTERNATIONAL_INFORMATION_CENTER_FOR_TERMINOLOGY_	[NGO] ;MleH 01 Jul 2010
INTERNATIONAL_INFORMATIZATION_ACADEMY_	[NGOEDU] ;MleH 01 Jul 2010
INTERNATIONAL_INNER_WHEEL_	[NGO] ;MleH 01 Jul 2010
INTERNATIONAL_INSTITUTE_FOR_APPLIED_SYSTEMS_ANALYSIS_	[NGOEDU] ;MleH 01 Jul 2010
INTERNATIONAL_INSTITUTE_FOR_NON_ALIGNED_STUDIES_	[NGO] ;MleH 01 Jul 2010
INTERNATIONAL_INSTITUTE_OF_ADMINISTRATIVE_SCIENCES_	[NGOEDUBUS] ;MleH 01 Jul 2010
INTERNATIONAL_INSTITUTE_OF_HIGHER_STUDIES_IN_CRIMINAL_SCIENCES_	[NGOITAHRI] ;MleH 01 Jul 2010
INTERNATIONAL_INSTITUTE_OF_HUMANITARIAN_LAW_(IIHL)	[NGOEURHRI] ;MleH 01 Jul 2010
INTERNATIONAL_INSTITUTE_OF_INTEGRAL_HUMAN_SCIENCES_	[NGOREL] ;MleH 01 Jul 2010
INTERNATIONAL_INSTITUTE_OF_RURAL_RECONSTRUCTION_	[NGODEV] ;MleH 01 Jul 2010
INTERNATIONAL_INSTITUTE_ON_PEACE_EDUCATION_	[NGOEDU] ;MleH 01 Jul 2010
INTERNATIONAL_KOLPING_SOCIETY_	[NGOCHRCTHDEV] ;MleH 01 Jul 2010
INTERNATIONAL_LEAGUE_FOR_THE_RIGHTS_AND_LIBERATION_OF_PEOPLES_	[NGOHRI] ;MleH 01 Jul 2010
INTERNATIONAL_LEAGUE_OF_SOCIETIES_FOR_PERSONS_WITH_MENTAL_HANDICAPS_	[NGOHLH] ;MleH 01 Jul 2010
INTERNATIONAL_MEDICAL_CORPS_	[NGOUSAHLH]
INTERNATIONAL_MEDICAL_CORPS_UK_	[NGOGBRHLH]
INTERNATIONAL_MISSION_ASSOCIATION_	[NGOKORCHRHLH] ;MleH 01 Jul 2010
INTERNATIONAL_MODEL_UNITED_NATIONS_ASSOCIATION_	[NGOEDU] ;MleH 01 Jul 2010
INTERNATIONAL_MOVEMENT_A.T.D._FOURTH_WORLD_	[NGODEV] ;MleH 01 Jul 2010
INTERNATIONAL_MOVEMENT_ATD_FOURTH_WORLD_	[NGODEV] ;MleH 01 Jul 2010
INTERNATIONAL_MOVEMENT_FOR_FRATERNAL_UNION_AMONG_RACES_AND_PEOPLES_	[NGO] ;MleH 01 Jul 2010
INTERNATIONAL_NETWORK_FOR_THE_PREVENTION_OF_ELDER_ABUSE_	[NGOHRI] ;MleH 01 Jul 2010
INTERNATIONAL_NETWORK_OF_PEACE_MUSEUMS_	[NGOEDU] ;MleH 01 Jul 2010
INTERNATIONAL_OCEAN_INSTITUTE_	[NGOENV] ;MleH 01 Jul 2010
INTERNATIONAL_ORGANIZATION_FOR_STANDARDIZATION_	[NGO] ;MleH 01 Jul 2010
INTERNATIONAL_ORGANIZATION_FOR_THE_ELIMINATION_OF_ALL_FORMS_OF_RACIAL_DISCRIMINATION_	[NGOHRI] ;MleH 01 Jul 2010
INTERNATIONAL_ORGANIZATION_OF_EMPLOYERS_	[NGOBUS] ;MleH 01 Jul 2010
INTERNATIONAL_PEACE_BUREAU_	[NGO] ;MleH 01 Jul 2010
INTERNATIONAL_PEACE_RESEARCH_ASSOCIATION_	[NGOEDU] ;MleH 01 Jul 2010
INTERNATIONAL_PHOTOGRAPHIC_COUNCIL_	[NGOMED] ;MleH 01 Jul 2010
INTERNATIONAL_PHYSICIANS_FOR_THE_PREVENTION_OF_NUCLEAR_WAR_	[NGOHLH] ;MleH 01 Jul 2010
INTERNATIONAL_POLITICAL_SCIENCE_ASSOCIATION_	[NGOEDU] ;MleH 01 Jul 2010
INTERNATIONAL_PRESS_INSTITUTE_	[NGOMED] ;MleH 01 Jul 2010
INTERNATIONAL_PROGRESS_ORGANIZATION_	[NGO] ;MleH 01 Jul 2010
INTERNATIONAL_PUBLIC_POLICY_INSTITUTE_	[NGO] ;MleH 01 Jul 2010
INTERNATIONAL_PUBLIC_RELATIONS_ASSOCIATION_	[NGOBUSMED] ;MleH 01 Jul 2010
INTERNATIONAL_PUBLISHERS_ASSOCIATION_	[NGOMED] ;MleH 01 Jul 2010
INTERNATIONAL_REAL_ESTATE_FEDERATION_	[NGOBUS] ;MleH 01 Jul 2010
INTERNATIONAL_REHABILITATION_COUNCIL_FOR_TORTURE_VICTIMS_	[NGOHLH] ;MleH 01 Jul 2010
INTERNATIONAL_RELIEF_FRIENDSHIP_FOUNDATION_	[NGO] ;MleH 01 Jul 2010
INTERNATIONAL_RESEARCH_CENTRE_FOR_ENVIRONMENTAL_STRUCTURES_PIO_MANZU_	[NGOITAENV] ;MleH 01 Jul 2010
INTERNATIONAL_ROAD_FEDERATION_	[NGO] ;MleH 01 Jul 2010
INTERNATIONAL_ROMANI_UNION_	[NGOEUR] ;MleH 01 Jul 2010
INTERNATIONAL_SAVE_THE_CHILDREN_ALLIANCE_	[NGO] ;MleH 01 Jul 2010
INTERNATIONAL_SCHOOLS_ASSOCIATION_	[NGOEDU] ;MleH 01 Jul 2010
INTERNATIONAL_SCIENTIFIC_COUNCIL_FOR_ISLAND_DEVELOPMENT_	[NGODEV] ;MleH 01 Jul 2010
INTERNATIONAL_SOCIAL_SCIENCE_COUNCIL_	[NGOEDU] ;MleH 01 Jul 2010
INTERNATIONAL_SOCIAL_SECURITY_ASSOCIATION_	[NGO] ;MleH 01 Jul 2010
INTERNATIONAL_SOCIAL_SERVICE_	[NGO] ;MleH 01 Jul 2010
INTERNATIONAL_SOCIETY_FOR_MANGROVE_ECOSYSTEMS_	[NGOJPNENV] ;MleH 01 Jul 2010
INTERNATIONAL_SOCIETY_FOR_PHOTOGRAMMETRY_&_REMOTE_SENSING_	[NGOEDU] ;MleH 01 Jul 2010
INTERNATIONAL_SOCIETY_FOR_PHOTOGRAMMETRY_AND_REMOTE_SENSING_	[NGOEDU] ;MleH 01 Jul 2010
INTERNATIONAL_SOCIETY_FOR_TRAUMATIC_STRESS_STUDIES_	[NGOHLH] ;MleH 01 Jul 2010
INTERNATIONAL_SOCIETY_OF_CITY_AND_REGIONAL_PLANNERS_	[NGOBUS] ;MleH 01 Jul 2010
INTERNATIONAL_SOCIETY_OF_NURSING_IN_CANCER_CARE_	[NGOHLH] ;MleH 01 Jul 2010
INTERNATIONAL_SOCIETY_OF_RADIOGRAPHERS_&_RADIOLOGICAL_TECHNICIANS_	[NGOHLH] ;MleH 01 Jul 2010
INTERNATIONAL_SOCIETY_OF_RADIOGRAPHERS_AND_RADIOLOGICAL_TECHNICIANS_	[NGOHLH] ;MleH 01 Jul 2010
INTERNATIONAL_SOCIOLOGICAL_ASSOCIATION_	[NGOEDU] ;MleH 01 Jul 2010
INTERNATIONAL_STATISTICAL_INSTITUTE_	[NGOEDU] ;MleH 01 Jul 2010
INTERNATIONAL_STUDIES_ASSOCIATION_	[NGOEDU] ;MleH 01 Jul 2010
INTERNATIONAL_TELECOMMUNICATION_ACADEMY_	[NGOMED] ;MleH 01 Jul 2010
INTERNATIONAL_TRADE_UNION_CONFEDERATION_	[NGOLAB] ;MleH 01 Jul 2010
INTERNATIONAL_TUNNELLING_AND_UNDERGROUND_SPACE_ASSOCIATION_	[NGO] ;MleH 01 Jul 2010
INTERNATIONAL_UNION_FOR_CONSERVATION_OF_NATURE_	[NGOENV] ;MleH 01 Jul 2010
INTERNATIONAL_UNION_FOR_HEALTH_PROMOTION_AND_EDUCATION_	[NGOHLH] ;MleH 01 Jul 2010
INTERNATIONAL_UNION_FOR_LAND_VALUE_TAXATION_AND_FREE_TRADE_	[NGOBUS] ;MleH 01 Jul 2010
INTERNATIONAL_UNION_OF_ARCHITECTS_	[NGO] ;MleH 01 Jul 2010
INTERNATIONAL_UNION_OF_BIOLOGICAL_SCIENCES_	[NGOEDU] ;MleH 01 Jul 2010
INTERNATIONAL_UNION_OF_BUILDING_CENTRES_	[NGOEURBUS] ;MleH 01 Jul 2010
INTERNATIONAL_UNION_OF_ECONOMISTS_	[NGOBUS] ;MleH 01 Jul 2010
INTERNATIONAL_UNION_OF_NUTRITIONAL_SCIENCES_	[NGOHLH] ;MleH 01 Jul 2010
INTERNATIONAL_UNION_OF_PSYCHOLOGICAL_SCIENCE_	[NGOEDU] ;MleH 01 Jul 2010
INTERNATIONAL_UNION_OF_SOCIALIST_YOUTH_	[NGOPTY] ;MleH 01 Jul 2010
INTERNATIONAL_UNION_OF_TECHNICAL_ASSOCIATIONS_AND_ORGANIZATIONS_	[NGOBUS] ;MleH 01 Jul 2010
INTERNATIONAL_UNION_OF_TENANTS_	[NGO] ;MleH 01 Jul 2010
INTERNATIONAL_WILDLIFE_COALITION_TRUST_	[NGOPHLENV] ;MleH 01 Jul 2010
INTERNATIONAL_WOMEN_JUDGES_FOUNDATION_	[NGOJUD] ;MleH 01 Jul 2010
INTERNATIONAL_YOUTH_AND_STUDENT_MOVEMENT_FOR_THE_UNITED_NATIONS_	[NGO] ;MleH 01 Jul 2010
INTERNATIONALE_DE_L'EDUCATION_	[NGOLABEDU] ;MleH 01 Jul 2010
INTERSOS_	[NGOITA]
INTERTANKO_	[NGOBUS] ;MleH 01 Jul 2010
INTERVIDA_WORLD_ALLIANCE_	[NGOESPDEV] ;MleH 01 Jul 2010
INTRAHEALTH_INTERNATIONAL_	[NGOHLH]; NGO_Actors
ISLAMIC/AFRICAN_RELIEF_AGENCY_	[NGOSDNMOS] ;MleH 01 Jul 2010
ISLAMIC_RELIEF_	[NGOMOSDEV]
ISMUN_	[NGO] ;MleH 01 Jul 2010
ITA_AITES_	[NGO] ;MleH 01 Jul 2010
ITFD_INTERNATIONAL_	[NGODEVMED] ;MleH 01 Jul 2010
IUHPE_	[NGOHLH] ;MleH 01 Jul 2010
IUPSYS_	[NGOEDU] ;MleH 01 Jul 2010
JAKOB_KELLENBERGER_	[NGOHLHIRC >000101]	; Red Cross and Red Crescent
JANE_GOODALL_INSTITUTE_	[NGOENV] ;MleH 01 Jul 2010
JAPAN_CENTER_FOR_CONFLICT_PREVENTION_	[NGOJPN]
JAPAN_PEACE_BOAT_	[NGOJPN]
JAPAN_WELL_AGING_ASSOCIATION_	[NGOJPNHLH] ;MleH 01 Jul 2010
JEUNES_MEDECINS_SANS_FRONTIERES_TUNISIE_	[NGOTUNHLH] ;MleH 01 Jul 2010
JEWISH_NATIONAL_FUND_	[NGOISRJEW] ;MleH 01 Jul 2010
JEWISH_WOMEN_INTERNATIONAL_	[NGOCANJEW] ;MleH 01 Jul 2010
JOHANNITER_INTERNATIONAL_ALLIANCE_	[NGODEUHLH]
JOSEPH_PARARAJASINGHAM_	[NGOTAM]
JOVENEX_EN_MOVIMIENTO_	[NGOREF] ;MleH 01 Jul 2010
JUAN_MANUEL_SUAREZ_DEL_TORO_RIVERO_	[NGOHLHIRC >011110]	; Red Cross and Red Crescent
JUDGES_WITHOUT_BORDERS_	[NGOJUD] ;MleH 01 Jul 2010
JUNIOR_CHAMBER_INTERNATIONAL_	[NGOREL] ;MleH 01 Jul 2010
KAPPA_DELTA_PI_	[NGONMREDU] ;MleH 01 Jul 2010
KARAMAH_	[NGOMOSJUDHRI] ;MleH 01 Jul 2010
KARP_KOREAN_ASSOCIATION_OF_RETIRED_PERSONS_	[NGOKOR] ;MleH 01 Jul 2010
KEGME_	[NGOEEU] ;MleH 01 Jul 2010
KERKINACTIE_	[NGONLDCHRPRO360]	; from Protestant Church in the Netherlands
KIDS_WITH_A_CAUSE_	[NGODEV] ;MleH 01 Jul 2010
KINDERDORF_INTERNATIONAL_	[NGODEU] ;MleH 01 Jul 2010
KIWANIS_INTERNATIONAL_	[NGO] ;MleH 01 Jul 2010
KOREA_INTERNATIONAL_VOLUNTEER_ORGANIZATION_	[NGOKOR] ;MleH 01 Jul 2010
LA_LECHE_LEAGUE_	[NGOHLH] ;MleH 01 Jul 2010
LANDMINE_ACTION_	[NGOGBR]
LAO_NEW_GENERATION_DEMOCRACY_MOVEMENT_	[NGOHRI]
LAWYERS_WITHOUT_BORDERS_	[NGOJUD] ;MleH 01 Jul 2010
LEGACY_INTERNATIONAL_	[NGOUSA] ;MleH 01 Jul 2010
LEGIAO_DA_BOA_VONTADE_	[NGOLAM] ;MleH 01 Jul 2010
LEGION_OF_GOOD_WILL_	[NGOLAM] ;MleH 01 Jul 2010
LEITNER_CENTER_FOR_INTERNATIIONAL_LAW_AND_JUSTICE_	[NGOUSAHRI] ;MleH 01 Jul 2010
LIBERAL_INTERNATIONAL_	[NGOPTY] ;MleH 01 Jul 2010
LIFE_AND_PEACE_INSTITUTE_	[NGOCHECHR] ;MleH 01 Jul 2010
LIFE_FOR_RELIEF_&_DEVELOPMENT_	[NGOUSAARBMOS]
LIFE_FOR_RELIEF_AND_DEVELOPMENT_	[NGOUSAARBMOS]
LIGHT_MILLENNIUM_	[NGO] ;MleH 01 Jul 2010
LINKS,_INC.	[NGOUSA] ;MleH 01 Jul 2010
LINKS_INC.	[NGOUSA] ;MleH 01 Jul 2010
LIONS_CLUBS_INTERNATIONAL_	[NGO] ;MleH 01 Jul 2010
LOOMBA_TRUST_	[NGO] ;MleH 01 Jul 2010
LORETTO_COMMUNITY_	[NGOUSACHRCTH] ;MleH 01 Jul 2010
LUTHERAN_IMMIGRATION_AND_REFUGEE_SERVICE_	[NGOUSAREF] ;MleH 01 Jul 2010
LUTHERAN_WORLD_FEDERATION_DEPARTMENT_FOR_WORLD_SERVICE_	[NGOCHRPRO214]
LUTHERAN_WORLD_FUND_TANZANIA_	[NGOTZACHRPRO214]
LUTHERAN_WORLD_RELIEF_	[NGOUSACHRPRODEV]
MAKE_A_WISH_FOUNDATION_	[NGOUSA] ;MleH 01 Jul 2010
MALTESER_INTERNATIONAL_	[NGOCHRCTH603]	; from Order of Malta
MANAGEMENT_ACCOUNTING_FOR_NON_GOVERNMENTAL_ORGANISATIONS_	[NGOGBR]
MANDAT_INTERNATIONAL_	[NGOCHE] ;MleH 01 Jul 2010
MANOS_UNIDAS_	[NGOESPDEV]
MAPACTION_	[NGOMED]
MARIE_STOPES_	[NGOHLH]; British, most clinics in Bangladesh; NGO_Actors
MARYKNOLL_FATHERS_AND_BROTHERS_	[NGOUSACHRCTH] ;MleH 01 Jul 2010
MATA_AMRITANANDAMAYI_MATH_	[NGOIND] ;MleH 01 Jul 2010
MATERCARE_INTERNATIONAL_	[NGOCHRCTHHLH] ;MleH 01 Jul 2010
MEDAIR_	[NGOCHR]
MEDECINS_DU_MONDE_	[NGOHLH] ;MleH 01 Jul 2010
MEDICAL_ASSISTANCE_PROGRAMS_INTERNATIONAL_	[NGOUSACHRHLH]
MEDICAL_KNOWLEDGE_INSTITUTE_	[NGOHLH] ;MleH 01 Jul 2010
MEDICAL_MISSION_SISTERS_	[NGOCHRCTHHLH] ;MleH 01 Jul 2010
MEDICAL_TEAMS_INTERNATIONAL_	[NGOUSACHRHLH]
MEDICAL_WOMEN'S_INTERNATIONAL_ASSOCIATION_	[NGOHLH] ;MleH 01 Jul 2010
MEDITERRANEAN_WOMEN'S_STUDIES_CENTRE_	[NGOEEU] ;MleH 01 Jul 2010
MEGA_CITIES_PROJECT_	[NGODEV] ;MleH 01 Jul 2010
MERCYEMEN_	[NGOYEM]
METHODIST_RELIEF_&_DEVELOPMENT_FUND_	[NGOGBRCHRPRO230]
METHODIST_RELIEF_AND_DEVELOPMENT_FUND_	[NGOGBRCHRPRO230]
MINBYUN_LAWYERS_FOR_A_DEMOCRATIC_SOCIETY_	[NGODEV]
MINES_ADVISORY_GROUP_	[NGO]
MONTREAL_SOCIAL_JUSTICE_COMMITTEE_	[NGOHRI]
MOUVEMENT_DU_NID_	[NGOHRI] ;MleH 01 Jul 2010
MOUVEMENT_MONDIAL_DES_MERES_	[NGO] ;MleH 01 Jul 2010
MOVIMIENTO_POR_LA_PAZ_EL_DESARME_Y_LA_LIBERTAD_	[NGOARBHRI] ;MleH 01 Jul 2010
MOVIMONDO_	[NGOITA]	; no real info. went into this
MUSLIM_AID_	[NGOGBRMOS] ;MleH 01 Jul 2010
MUSLIM_WOMEN_LAWYERS_FOR_HUMAN_RIGHTS_	[NGOMOSJUDHRI] ;MleH 01 Jul 2010
NATIONAL_COUNCIL_ON_FAMILY_RELATIONS_	[NGONMR] ;MleH 01 Jul 2010
NATIONAL_FOREIGN_TRADE_COUNCIL_	[NGOBUS] ;MleH 01 Jul 2010
NATIONAL_SERVICE_CONFERENCE_OF_THE_AMERICAN_ETHICAL_UNION_	[NGOUSA] ;MleH 01 Jul 2010
NATIONAL_SPACE_SOCIETY_	[NGO] ;MleH 01 Jul 2010
NATURAL_RESOURCES_DEFENCE_COUNCIL_	[NGOUSAENV] ;MleH 01 Jul 2010
NCFR_	[NGONMR] ;MleH 01 Jul 2010
NEAR_EAST_FOUNDATION_	[NGOUSADEV] ;MleH 01 Jul 2010
NESOHR_	[NGOHRI]
NETWORK_EARTH_VILLAGE_	[NGOJPNENV] ;MleH 01 Jul 2010
NEW_HUMAN_RIGHTS_	[NGOHRI] ;MleH 01 Jul 2010
NEW_ZEALAND_CAMPAIGN_AGAINST_LANDMINES_	[NGONZL]
NEXUS_INTERNATIONAL_BROADCASTING_ASSOCIATION_	[NGOMED] ;MleH 01 Jul 2010
NGARMSUK_RATTANASATHIEN_	[NGOHRI]
NGO_HEALTH_COMMITTEE_	[NGOHLH] ;MleH 01 Jul 2010
NICK_CHEESMAN_	[NGOHRI]
NIGHTINGALE_INITIATIVE_FOR_GLOBAL_HEALTH_	[NGOHLH] ;MleH 01 Jul 2010
NORD_SUD_XXI_	[NGO] ;MleH 01 Jul 2010
NORTHEAST_SECRETARIAT_OF_HUMAN_RIGHTS_	[NGOTAM]
NORTHEAST_SECRETARIAT_ON_HUMAN_RIGHTS_	[NGOTAM]
NORTHERN_FORUM_	[NGO] ;MleH 01 Jul 2010
NORWEGIAN_CHURCH_AID_	[NGONORCHRPRO]
NORWEGIAN_PEOPLE'S_AID_	[NGONOR]
NOUVEAUX_DROITS_DE_L'HOMME_	[NGOHRI] ;MleH 01 Jul 2010
OATUU_	[NGOAFRLAB] ;MleH 01 Jul 2010
OBSERVATORY_FOR_CULTURAL_AND_AUDIOVISUAL_COMMUNICATION_	[NGOITAMED] ;MleH 01 Jul 2010
OCKENDEN_INTERNATIONAL_	[NGOGBRREF]
OFADEC_	[NGOAFRDEV]
OFFICE_AFRICAIN_POUR_LE_DEVELOPPEMENT_ET_LA_COOPERATION_	[NGOAFRDEV]
OIEC_	[NGOCHRCTHEDU] ;MleH 01 Jul 2010
OIKOS_COOPERACAO_E_DESENVOLVIMENTO_	[NGOPRTDEV]
OIPA_	[NGOENV] ;MleH 01 Jul 2010
OLOF_PALME_PEACE_FOUNDATION_	[NGOSWE] ;MleH 01 Jul 2010
OPERATION_MERCY_	[NGODEV]
OPERATION_PEACE_THROUGH_UNITY_	[NGO] ;MleH 01 Jul 2010
OPERATION_USA_	[NGOUSA] ;MleH 01 Jul 2010
ORGANISATION_DEVELOPMENT_AND_TRAINING_	[NGODEV]
ORGANISATION_INTERNATIONALE_POUR_LA_PROTECTION_DES_ANIMAUX_	[NGOENV] ;MleH 01 Jul 2010
ORGANIZATION_OF_AFRICAN_TRADE_UNION_UNITY_	[NGOAFRLAB] ;MleH 01 Jul 2010
ORGANIZATION_OF_ISLAMIC_CAPITALS_AND_CITIES_	[NGOMOS] ;MleH 01 Jul 2010
ORPHANS_INTERNATIONAL_	[NGO] ;MleH 01 Jul 2010
ORT_AMERICA_	[NGOUSAJEWEDU] ;MleH 01 Jul 2010
OSAKA_JUNIOR_CHAMBER_	[NGO] ;MleH 01 Jul 2010
OSMTH_	[NGOISRCHR] ;MleH 01 Jul 2010
OTTAWA_HUMAN_RIGHTS_INTERNET_	[NGOHRI]
OVERSEAS_PRESS_CLUB_OF_AMERICA_	[NGOUSAMED] ;MleH 01 Jul 2010
PACIFIC_CONCERNS_RESOURCE_CENTRE_	[NGOFJI] ;MleH 01 Jul 2010
PAN_AFRICAN_INSTITUTE_FOR_DEVELOPMENT_	[NGOAFRDEV] ;MleH 01 Jul 2010
PAN_AMERICAN_DEVELOPMENT_FOUNDATION_	[NGOLAMDEV] ;MleH 01 Jul 2010
PAN_PACIFIC_AND_SOUTHEAST_ASIA_WOMEN'S_ASSOCIATION_	[NGOSEADEV] ;MleH 01 Jul 2010
PARTNERSHIP_FOR_GLOBAL_JUSTICE_	[NGOUSACHR] ;MleH 01 Jul 2010
PARTNERSHIP_FOR_INDIGENOUS_PEOPLES_ENVIRONMENT_	[NGOENV] ;MleH 01 Jul 2010
PATHWAYS_TO_PEACE_	[NGO] ;MleH 01 Jul 2010
PAX_CHRISTI_INTERNATIONAL_	[NGOCHRCTH] ;MleH 01 Jul 2010
PAZ_Y_COOPERACION_	[NGO] ;MleH 01 Jul 2010
PEACE_ACTION_	[NGOUSA] ;MleH 01 Jul 2010
PEACE_BOAT_	[NGOJPN] ;MleH 01 Jul 2010
PEACE_CHILD_INTERNATIONAL_	[NGOGBRDEV] ;MleH 01 Jul 2010
PEACE_EDUCATION_FOUNDATION_	[NGOEDU] ;MleH 01 Jul 2010
PEACE_PARTNERSHIP_INTERNATIONAL_	[NGOCAS] ;MleH 01 Jul 2010
PEACE_WINDS_JAPAN_	[NGOJPN]
PEACEMAKER_CORPS_ASSOCIATION_	[NGOUSA] ;MleH 01 Jul 2010
PEACEWORKERS/NONVIOLENT_PEACEFORCE_	[NGO] ;MleH 01 Jul 2010
PEARL_S._BUCK_INTERNATIONAL_	[NGOUSAEDU] ;MleH 01 Jul 2010
PHYSICIANS_FOR_PEACE_	[NGOHLH] ;MleH 01 Jul 2010
PLAN_INTERNATIONAL_	[NGODEV] ;MleH 01 Jul 2010
PLANETAFILLIA_	[NGOMEX] ;MleH 01 Jul 2010
PLANNED_PARENTHOOD_FEDERATION_	[NGOUSAHLH] ;MleH 01 Jul 2010
POPULATION_COUNCIL_	[NGODEV] ;MleH 01 Jul 2010
POPULATION_INSTITUTE_	[NGOUSA] ;MleH 01 Jul 2010
PPSEAWA_	[NGOSEADEV] ;MleH 01 Jul 2010
PREMIERE_URGENCE_	[NGOFRA]
PRISON_FELLOWSHIP_INTERNATIONAL_	[NGOCHR] ;MleH 01 Jul 2010
PRODEFA_	[NGOESP] ;MleH 01 Jul 2010
PROGRAM_FOR_APPROPRIATE_TECHNOLOGY_IN_HEALTH_	[NGOHLH] ;MleH 01 Jul 2010
PROJECT_PLOUGHSHARES_	[NGOCANCHR] ;MleH 01 Jul 2010
PROMOTING_ENDURING_PEACE_	[NGOUSA] ;MleH 01 Jul 2010
PUBLIC_PRIVATE_ALLIANCE_FOUNDATION_	[NGODEV] ;MleH 01 Jul 2010
PUBLIC_RELATIONS_SOCIETY_OF_AMERICA_	[NGOMED] ;MleH 01 Jul 2010
PUGWASH_CONFERENCES_ON_SCIENCE_AND_WORLD_AFFAIRS_	[NGO] ;MleH 01 Jul 2010
QUAKER_EARTHCARE_WITNESS_	[NGOCHRPROENV] ;MleH 01 Jul 2010
QUICK_RELIEF_FOUNDATION_	[NGOHUN] ;MleH 01 Jul 2010
QUOTA_INTERNATIONAL_	[NGO] ;MleH 01 Jul 2010
RADDA_BARNEN_	[NGOSWEDEV] ;MleH 01 Jul 2010
RAINFOREST_FOUNDATION_INTERNATIONAL_	[NGOENV] ;MleH 01 Jul 2010
RDRS_BANGLADESH_	[NGOBGDCHRPRO214]
REACH_OUT_REFUGEE_PROTECTION_TRAINING_PROJECT_	[NGOREF]
RED_CROSS_EU_OFFICE_	[NGOHLHIRC]
RED_DE_SALUD_DE_LAS_MUJERES_LATINOAMERICANAS_Y_DEL_CARIBE_	[NGOLAM] ;MleH 01 Jul 2010
REDR_	[NGO]
RELIEF_INTERNATIONAL_	[NGOUSA]
RENE_DUBOS_CENTER_FOR_HUMAN_ENVIRONMENTS_	[NGOUSAENV] ;MleH 01 Jul 2010
RESEARCH_ACTION_AND_INFORMATION_NETWORK_FOR_BODILY_INTEGRITY_OF_WOMEN_	[NGOHLH] ;MleH 01 Jul 2010
REVIVAL_OF_ISLAMIC_HERITAGE_SOCIETY_	[NGOMOS]
RIBBON_INTERNATIONAL_	[NGO] ;MleH 01 Jul 2010
RIHS_	[NGOMOS]
ROBERT_F._KENNEDY_MEMORIAL_CENTER_FOR_HUMAN_RIGHTS_	[NGOUSAHRI] ;MleH 01 Jul 2010
ROCKEFELLER_FOUNDATION_	[NGOUSA] ;MleH 01 Jul 2010
ROOTS_OF_PEACE_	[NGOAGR] ;MleH 01 Jul 2010
ROTES_KREUZ_	[NGOHLHRCI]
ROYAL_ACADEMY_OF_SCIENCE_INTERNATIONAL_TRUST_	[NGO] ;MleH 01 Jul 2010
S.O.S._ATTENTATS_	[NGOFRA] ;MleH 01 Jul 2010
SADOCC_	[NGOAFREDU] ;MleH 01 Jul 2010
SAINT_JOAN'S_INTERNATIONAL_ALLIANCE_	[NGOCHRCTH] ;MleH 01 Jul 2010
SARATOGA_FOUNDATION_FOR_WOMEN_WORLDWIDE_	[NGOUSA] ;MleH 01 Jul 2010
SAVE_THE_CHILDREN_FUND_	[NGODEV] ;MleH 01 Jul 2010
SAVE_THE_CHILDREN_SWEDEN_	[NGOSWEDEV] ;MleH 01 Jul 2010
SCIENCE_FOR_PEACE_	[NGOCANEDU] ;MleH 01 Jul 2010
SECOURISTES_SANS_FRONTIERES_	[NGOFRA]
SEEDS_OF_PEACE,_INC.	[NGOUSA] ;MleH 01 Jul 2010
SEEDS_OF_PEACE_INC.	[NGOUSA] ;MleH 01 Jul 2010
SERPAJ_AL_	[NGOLAM] ;MleH 01 Jul 2010
SERVAS_INTERNATIONAL_	[NGO] ;MleH 01 Jul 2010
SERVAS_OPEN_DOORS_	[NGO] ;MleH 01 Jul 2010
SERVICE_FOR_PEACE_	[NGO] ;MleH 01 Jul 2010
SERVICIO_PAZ_Y_JUSTICIA_EN_AMERICA_LATINA_	[NGOLAM] ;MleH 01 Jul 2010
SHARED_INTEREST_	[NGOBUS] ;MleH 01 Jul 2010
SIERRA_CLUB_	[NGOUSAENV] ;MleH 01 Jul 2010
SIGHTSAVERS_	[NGOHLH]
SIGMA_GAMMA_RHO_	[NGOEDU] ;MleH 01 Jul 2010
SIGMA_THETA_TAU_	[NGOHLHEDU] ;MleH 01 Jul 2010
SIMON_WIESENTHAL_CENTER_	[NGOJEW] ;MleH 01 Jul 2010
SISTER_TO_SISTER_INTERNATIONAL_	[NGO] ;MleH 01 Jul 2010
SISTERS_OF_LORETTO_	[NGOUSACHRCTH] ;MleH 01 Jul 2010
SMALL_KINDNESS_	[NGO] ;MleH 01 Jul 2010
SOCIAL_JUSTICE_COMMITTEE_MONTREAL_	[NGOHRI]
SOCIALIST_INTERNATIONAL_	[NGOPTY] ;MleH 01 Jul 2010
SOCIETY_FOR_INTERNATIONAL_DEVELOPMENT_	[NGODEV] ;MleH 01 Jul 2010
SOCIETY_FOR_PUBLIC_HEALTH_EDUCATION_	[NGOHLH] ;MleH 01 Jul 2010
SOCIETY_OF_CATHOLIC_MEDICAL_MISSIONARIES_	[NGOCHRCTHHLH] ;MleH 01 Jul 2010
SOCIETY_OF_THE_REVIVAL_OF_ISLAMIC_HERITAGE_	[NGOMOS]
SOCIOLOGISTS_FOR_WOMEN_IN_SOCIETY_	[NGOEDUDEV] ;MleH 01 Jul 2010
SOROPTIMIST_INTERNATIONAL_	[NGODEV] ;MleH 01 Jul 2010
SOS_CHILREN_	[NGO]
SOS_KINDERDORF_	[NGO]
SOUTHERN_AFRICA_COMMITTEE_	[NGOSAFHRI] ;MleH 01 Jul 2010
SOUTHERN_AFRICA_DOCUMENTATION_AND_CO_OPERATION_CENTRE_	[NGOAFREDU] ;MleH 01 Jul 2010
SOVEREIGN_MILITARY_ORDER_OF_THE_TEMPLE_OF_JERUSALEM_	[NGOISRCHR] ;MleH 01 Jul 2010
SPECIAL_OLYMPICS_	[NGO] ;MleH 01 Jul 2010
SPHERE_INDIA_	[NGOIND]
SPSSI_	[NGOUSAEDU] ;MleH 01 Jul 2010
STAFFORDSHIRE_AMBULANCE_STAFF_HUMANITARIAN_AID_	[NGOGBRHLH]
STAKEHOLDER_FORUM_FOR_FUTURE_	[NGOENV]
STUDENT_WORLD_ASSEMBLY_	[NGOHRI] ;MleH 01 Jul 2010
SUDAN_HUMAN_RIGHTS_ORGANISATION_	[NGOSDNHRI]; NGO_Actors
SUNSAT_ENERGY_COUNCIL_	[NGOENV] ;MleH 01 Jul 2010
SUSIE_REIZOD_FOUNDATION_	[NGOUSADEV] ;MleH 01 Jul 2010
SUSILA_DHARMA_INTERNATIONAL_ASSOCIATION_	[NGO] ;MleH 01 Jul 2010
SUSTAINABLE_ENVIRONMENT_AND_ECOLOGICAL_DEVELOPMENT_SOCIETY_	[NGOIND]
SWISS_FOUNDATION_FOR_MINE_ACTION_	[NGOCHE]
SYMPHONY_FOR_UNITED_NATIONS_	[NGOUSAMED] ;MleH 01 Jul 2010
SYNERGOS_INSTITUTE_	[NGODEV] ;MleH 01 Jul 2010
TAKINGITGLOBAL_	[NGOCAN] ;MleH 01 Jul 2010
TANGANYIKA_CHRISTIAN_REFUGEE_SERVICE_	[NGOTZACHRPRO214]
TEACHERS_OF_ENGLISH_TO_SPEAKERS_OF_OTHER_LANGUAGES_	[NGOEDU] ;MleH 01 Jul 2010
TEARFUND_	[NGOCHRPRO]
TELECOMS_SANS_FRONTIERES_	[NGOMED]
TEMPLE_OF_UNDERSTANDING_	[NGOREL] ;MleH 01 Jul 2010
TERRE_DES_HOMMES_	[NGO]
TESOL_	[NGOEDU] ;MleH 01 Jul 2010
THE_ASIA_SOCIETY_	[NGOASA] ;MleH 01 Jul 2010
THE_CATHOLIC_AGENCY_FOR_WORLD_DEVELOPMENT_	[NGOIRLCHRCTHDEV] ;MleH 01 Jul 2010
THE_FRIENDSHIP_FORCE_	[NGOUSA] ;MleH 01 Jul 2010
THE_IU_	[NGOBUS] ;MleH 01 Jul 2010
THE_JOHANNITER_	[NGODEUHLH]
THE_SPHERE_PROJECT_	[NGO]
THIMUN_FOUNDATION_	[NGOEDU] ;MleH 01 Jul 2010
THIRD_WORLD_MOVEMENT_AGAINST_THE_EXPLOITATION_OF_WOMEN_	[NGOSEAHRI] ;MleH 01 Jul 2010
TOKYO_JUNIOR_CHAMBER_	[NGOJPN] ;MleH 01 Jul 2010
TORTURE_ABOLITION_AND_SURVIVORS_SUPPORT_COALITION_	[NGOHRI]; NGO_Actors
TRACE_INTERNATIONAL_	[NGODEV] ;MleH 01 Jul 2010
TRANSNATIONAL_IMMIGRATION_&_REFUGEE_GROUP_	[NGOUSAHRI] ;MleH 01 Jul 2010
TRANSNATIONAL_IMMIGRATION_AND_REFUGEE_GROUP_	[NGOUSAHRI] ;MleH 01 Jul 2010
TRIANGLE_GENERATION_HUMANITAIRE_	[NGO]
TRIBAL_LINK_FOUNDATION_	[NGO] ;MleH 01 Jul 2010
TRICKLE_UP_PROGRAM_	[NGODEV] ;MleH 01 Jul 2010
TROCAIRE_	[NGOIRLCHRCTHDEV] ;MleH 01 Jul 2010
UIGHUR_AMERICAN_ASSOCIATION_	[NGOUSAUIG]
UK_NETWORK_FOR_CIVIL_SOCIETY_LINK_WITH_UN_GENERAL_ASSEMBLY_	[NGOGBR] ;MleH 01 Jul 2010
UNGA_LINK_UK_	[NGOGBR] ;MleH 01 Jul 2010
UNIAPRAVI_	[NGOLAMDEV] ;MleH 01 Jul 2010
UNION_DES_FOIRES_INTERNATIONALES_	[NGOBUS] ;MleH 01 Jul 2010
UNION_IBEROAMERICANA_DE_COLEGIOS_Y_AGRUPACIONES_DE_ABOGADOS_	[NGOLAMJUD] ;MleH 01 Jul 2010
UNION_INTERNATIONALE_DE_L'INDUSTRIE_DU_GAZ_	[NGOBUS] ;MleH 01 Jul 2010
UNION_OF_ARAB_BANKS_	[NGOARBBUS] ;MleH 01 Jul 2010
UNION_OF_INTERNATIONAL_ASSOCIATIONS_	[NGO] ;MleH 01 Jul 2010
UNION_PROFESSIONNELLE_DES_EXPERTS_MARITIMES_	[NGOFRABUS] ;MleH 01 Jul 2010
UNIPAX_UNIONE_MONDIALE_PER_LA_PACE_ED_I_DIRITTI_FONDAMENTALI_DELL'UOMO_E_DEI_POPOLI_	[NGOITA] ;MleH 01 Jul 2010
UNITE_FOR_SIGHT_	[NGOUSAHLH] ;MleH 01 Jul 2010
UNITED_CHURCH_OF_CHRIST_COMMISSION_FOR_RACIAL_JUSTICE_	[NGOCHRPRO] ;MleH 01 Jul 2010
UNITED_CHURCH_OF_CHRIST_JUSTICE_AND_WITNESS_MINISTRIES_	[NGOCHRPRO] ;MleH 01 Jul 2010
UNITED_CHURCH_OF_CHRIST_WIDER_CHURCH_MINISTRIES_	[NGOCHRPRO] ;MleH 01 Jul 2010
UNITED_METHODIST_CHURCH_GENERAL_BOARD_OF_GLOBAL_MINISTRIES_	[NGOCHRPRO] ;MleH 01 Jul 2010
UNITED_METHODIST_COMMITTEE_ON_RELIEF_	[NGOCHRPRO230]
UNITED_NATIONS_WATCH_	[NGO] ;MleH 01 Jul 2010
UNITED_RELIGIONS_INITIATIVE_	[NGOREL] ;MleH 01 Jul 2010
UNITED_SIKHS_	[NGOSIKDEV] ;MleH 01 Jul 2010
UNIVERSAL_ESPERANTO_ASSOCIATION_	[NGO] ;MleH 01 Jul 2010
UNIVERSAL_FEDERATION_OF_TRAVEL_AGENTS_ASSOCIATIONS_	[NGOBUS] ;MleH 01 Jul 2010
UNIVERSAL_HUMAN_RIGHTS_NETWORK_	[NGOUSAHRI] ;MleH 01 Jul 2010
US_ASIA_INSTITUTE_	[NGOUSA] ;MleH 01 Jul 2010
VERIFICATION_RESEARCH_TRAINING_AND_INFORMATION_CENTRE_	[NGO] ;MleH 01 Jul 2010
VIRGINIA_GILDERSLEEVE_INTERNATIONAL_FUND_	[NGOUSADEV] ;MleH 01 Jul 2010
VITAL_VOICES_GLOBAL_PARTNERSHIP_	[NGOUSA] ;MleH 01 Jul 2010
VIVA_RIO_	[NGOBRADEV] ;MleH 01 Jul 2010
VOLUNTARY_ORGANISATIONS_IN_COOPERATION_IN_EMERGENCIES_	[NGOEUR]
VOLUNTEERS_OF_AMERICA_	[NGOUSACHRPRO]
WAGGGS_	[NGOEDU] ;MleH 01 Jul 2010
WAR_AND_PEACE_FOUNDATION_	[NGO] ;MleH 01 Jul 2010
WAR_VETERANS_COMMITTEE_	[NGOCASCVL] ;MleH 01 Jul 2010
WATER_FOR_PEOPLE_	[NGOUSADEV] ;MleH 01 Jul 2010
WFUNA_	[NGO] ;MleH 01 Jul 2010
WITTENBERG_CENTER_FOR_ALTERNATIVE_RESOURCES_	[NGORELENV] ;MleH 01 Jul 2010
WIZO_	[NGOISRJEW] ;MleH 01 Jul 2010
WLFD_	[NGO] ;MleH 01 Jul 2010
WOMEN_FOR_INTERNATIONAL_PEACE_AND_ARBITRATION_	[NGO] ;MleH 01 Jul 2010
WOMEN_OF_REFORM_JUDAISM_	[NGOJEW] ;MleH 01 Jul 2010
WOMEN_OF_VISION_	[NGOUSADEV] ;MleH 01 Jul 2010
WOMEN_WAGING_PEACE_	[NGO] ;MleH 01 Jul 2010
WOMEN'S_COMMISSION_FOR_REFUGEE_WOMEN_AND_CHILDREN_	[NGOREF] ;MleH 01 Jul 2010
WOMEN'S_HEALTH_AND_EDUCATION_CENTER_	[NGOUSAHLH] ;MleH 01 Jul 2010
WOMEN'S_INSTITUTE_FOR_FREEDOM_OF_THE_PRESS_	[NGOUSAHRI] ;MleH 01 Jul 2010
WOMEN'S_INTERNATIONAL_LEAGUE_FOR_PEACE_AND_FREEDOM_	[NGODEV] ;MleH 01 Jul 2010
WOMEN'S_NATIONAL_BOOK_ASSOCIATION_	[NGOEDU] ;MleH 01 Jul 2010
WOMEN'S_OVERSEAS_SERVICE_LEAGUE_	[NGOUSAMIL] ;MleH 01 Jul 2010
WOMEN'S_REFUGEE_COMMISSION_	[NGOUSAREF]
WOMEN'S_WORLD_BANKING_	[NGODEV] ;MleH 01 Jul 2010
WOMEN'S_ZIONIST_ORGANIZATION_OF_AMERICA_	[NGOUSAJEW] ;MleH 01 Jul 2010
WORLD_ACADEMY_OF_ART_AND_SCIENCE_	[NGOEDU] ;MleH 01 Jul 2010
WORLD_ADDICTION_FOUNDATION_	[NGOHLH] ;MleH 01 Jul 2010
WORLD_ALLIANCE_FOR_BREASTFEEDING_ACTION_	[NGOHLH] ;MleH 01 Jul 2010
WORLD_ALLIANCE_FOR_CITIZEN_PARTICIPATION_	[NGO] ;MleH 01 Jul 2010
WORLD_ALLIANCE_OF_YOUNG_MEN'S_CHRISTIAN_ASSOCIATIONS_	[NGOCHR] ;MleH 01 Jul 2010
WORLD_ASSEMBLY_OF_MUSLIM_YOUTH_	[NGOMOSEDU] ;MleH 01 Jul 2010
WORLD_ASSEMBLY_OF_YOUTH_	[NGO] ;MleH 01 Jul 2010
WORLD_ASSOCIATION_FOR_PSYCHOSOCIAL_REHABILITATION_	[NGOHLH] ;MleH 01 Jul 2010
WORLD_ASSOCIATION_OF_CHILDREN'S_FRIENDS_	[NGOMCO] ;MleH 01 Jul 2010
WORLD_ASSOCIATION_OF_EARLY_CHILDHOOD_EDUCATORS_	[NGOEDU] ;MleH 01 Jul 2010
WORLD_ASSOCIATION_OF_GIRL_GUIDES_AND_GIRL_SCOUTS_	[NGOEDU] ;MleH 01 Jul 2010
WORLD_ASSOCIATION_OF_NEWSPAPERS_	[NGOMEDHRI] ;MleH 01 Jul 2010
WORLD_BLIND_UNION_	[NGOHRI] ;MleH 01 Jul 2010
WORLD_CARES_CENTER_	[NGOUSADEV] ;MleH 01 Jul 2010
WORLD_CHIROPRACTIC_ALLIANCE_	[NGOHLH] ;MleH 01 Jul 2010
WORLD_COAL_INSTITUTE_	[NGOBUS] ;MleH 01 Jul 2010
WORLD_CONFEDERATION_OF_LABOUR_	[NGOEURLAB] ;MleH 01 Jul 2010
WORLD_CONFEDERATION_OF_PRODUCTIVITY_SCIENCE_	[NGOBUS] ;MleH 01 Jul 2010
WORLD_COUNCIL_FOR_CURRICULUM_AND_INSTRUCTION_	[NGOEDU] ;MleH 01 Jul 2010
WORLD_COUNCIL_OF_MUSLIM_COMMUNITIES_	[NGOMOS] ;MleH 01 Jul 2010
WORLD_EDUCATION_FELLOWSHIP_	[NGOEDU] ;MleH 01 Jul 2010
WORLD_ENERGY_COUNCIL_	[NGOENV] ;MleH 01 Jul 2010
WORLD_FEDERALIST_MOVEMENT_	[NGO] ;MleH 01 Jul 2010
WORLD_FEDERATION_OF_CONSULS_	[NGO] ;MleH 01 Jul 2010
WORLD_FEDERATION_OF_METHODIST_AND_UNITING_CHURCH_WOMEN_	[NGOCHRPRO] ;MleH 01 Jul 2010
WORLD_FEDERATION_OF_OCCUPATIONAL_THERAPISTS_	[NGOHLH] ;MleH 01 Jul 2010
WORLD_FEDERATION_OF_THE_DEAF_	[NGODEV] ;MleH 01 Jul 2010
WORLD_FEDERATION_OF_UKRAINIAN_WOMEN'S_ORGANIZATIONS_	[NGODEV] ;MleH 01 Jul 2010
WORLD_FEDERATION_OF_UNESCO_CLUBS_CENTRES_AND_ASSOCIATIONS_	[NGO] ;MleH 01 Jul 2010
WORLD_FORUM_OF_CIVIL_SOCIETY_NETWORKS_	[NGO] ;MleH 01 Jul 2010
WORLD_HUNGER_YEAR_	[NGODEV] ;MleH 01 Jul 2010
WORLD_ISLAMIC_CALL_SOCIETY_	[NGOMOS] ;MleH 01 Jul 2010
WORLD_JEWISH_CONGRESS_	[NGOJEW] ;MleH 01 Jul 2010
WORLD_JURIST_ASSOCIATION_OF_THE_WORLD_PEACE_THROUGH_LAW_CENTER_	[NGOJUD] ;MleH 01 Jul 2010
WORLD_LEAGUE_FOR_FREEDOM_AND_DEMOCRACY_	[NGO] ;MleH 01 Jul 2010
WORLD_LEBANESE_CULTURAL_UNION_	[NGOLBN] ;MleH 01 Jul 2010
WORLD_LP_GAS_ASSOCIATION_	[NGOBUS] ;MleH 01 Jul 2010
WORLD_MOVEMENT_OF_MOTHERS_	[NGO] ;MleH 01 Jul 2010
WORLD_MUSLIM_CONGRESS_	[NGOMOS] ;MleH 01 Jul 2010
WORLD_NEIGHBOURS_	[NGODEV]; generalized development; NGO_Actors
WORLD_ORGANISATION_OF_BUILDING_OFFICIALS_	[NGOBUS] ;MleH 01 Jul 2010
WORLD_ORGANIZATION_FOR_EARLY_CHILDHOOD_EDUCATION_	[NGODEV] ;MleH 01 Jul 2010
WORLD_ORGANIZATION_OF_JEWS_FROM_ARAB_COUNTRIES_	[NGOJEWREF] ;MleH 01 Jul 2010
WORLD_ORGANIZATION_OF_THE_SCOUT_MOVEMENT_	[NGOEDU] ;MleH 01 Jul 2010
WORLD_ORT_	[NGOJEWEDU] ;MleH 01 Jul 2010
WORLD_PSYCHIATRIC_ASSOCIATION_	[NGOHLH] ;MleH 01 Jul 2010
WORLD_SECURITY_INSTITUTE_	[NGOUSAMED] ;MleH 01 Jul 2010
WORLD_SOCIETY_FOR_THE_PROTECTION_OF_ANIMALS_	[NGOENV] ;MleH 01 Jul 2010
WORLD_SOCIETY_OF_VICTIMOLOGY_	[NGOJUD] ;MleH 01 Jul 2010
WORLD_UNION_OF_CATHOLIC_WOMEN'S_ORGANIZATIONS_	[NGOCHRCTHHRI] ;MleH 01 Jul 2010
WORLD_UYGHUR_CONGRESS_	[NGOUIG]
WORLD_VETERANS_FEDERATION_	[NGOCVL] ;MleH 01 Jul 2010
WORLD_WINTER_CITIES_ASSOCIATION_FOR_MAYORS_	[NGO] ;MleH 01 Jul 2010
WORLD_WOMAN'S_CHRISTIAN_TEMPERANCE_UNION_	[NGOUSACHR] ;MleH 01 Jul 2010
WSPA_	[NGOENV] ;MleH 01 Jul 2010
WWSF_	[NGODEV] ;MleH 01 Jul 2010
WZOA_	[NGOUSAJEW] ;MleH 01 Jul 2010
YACHAY_WASI_	[NGOPER]; NGO_Actors
YOKOHAMA_INTERNATIONAL_HUMAN_RIGHTS_CENTER_	[NGOJPNHRI] ;MleH 01 Jul 2010
YOUNG_WOMEN'S_CHRISTIAN_ASSOCIATION_	[NGONGACHR] ;MleH 01 Jul 2010
YOUNG_WOMEN'S_CHRISTIAN_ASSOCIATION_OF_NIGERIA_	[NGONGACHR] ;MleH 01 Jul 2010
YOUNG_WOMEN'S_CHRISTIAN_ASSOCIATION_OF_THE_UNITED_STATES_OF_AMERICA_	[NGONGACHR] ;MleH 01 Jul 2010
YOUTH_FOR_UNITY_AND_VOLUNTARY_ACTION_	[NGO] ;MleH 01 Jul 2010
ZAKA_RESCUE_AND_RECOVERY_	[NGOISRHLH] ;MleH 01 Jul 2010
ZETA_PHI_BETA_SORORITY_	[NGOUSAEDU] ;MleH 01 Jul 2010
ZNANIE_	[NGORUS] ;MleH 01 Jul 2010
ZONTA_	[NGODEV]; NGO_ActorsSource: Relig.Leaders.MLH.actors
HAMID_ALGABID_	[MOS]
JAGJIT_S_ARORA_	[SIK]
RAM_RAGHBIR_CHAHAL_	[SIK]; ReligiousGroups.txt
SIKH_	[SIK]
BAHA'I_INTERNATIONAL_COMMITTEE_	[BAH]; NGO_Actors
HUMAN_RIGHTS_WATCH_	[HRWHRI]
JOHN_TSANG_	[CHNHKGGOVBUS] ;MleH 11 Aug 2009; AllOtherCountries.txt
JOSEPH_ZEN_	[CHNHKGCHRCTHHRI] ;MleH 04 Aug 2009; AllOtherCountries.txt
ASIAN_DEVELOPMENT_BANK_ 	[IGOASADEVADB] ;MleH 22 Jul 2009; NGO_Actors
BIMSTEC_	[IGOASABUS] ;MleH 20 Jul 2009; NGO_Actors
CENSAD_	[IGONAFBUSCSS]; community_of_sahel-saharan_states; NGO_Actors
COCOA_PRODUCER'S_ALLIANCE_	[IGOAGRCPA]; NGO_Actors
COMMON_MARKET_FOR_EASTERN_AND_SOUTHERN_AFRICA_	[IGOAFRBUSCES]; NGO_Actors
HUMAN_RIGHTS_ORGANIZATION_	[NGOHRI] ;MleH 21 Jul 2009; NGO_Actors
INTERNATIONAL_GRAINS_COUNCIL_	[IGOAGRIGC]; NGO_Actors
INTERNATIONAL_HUMAN_RIGHTS_GROUP_	[NGOHRI] ;ELH 13 Jul 2009; NGO_Actors
INTERNATIONAL_TELECOMMUNICATIONS_UNION_	[IGOUNOMED] ;MleH 13 Aug 2009; NGO_Actors
ORGANIZATION_OF_ARAB_PETROLEUM_EXPORTING_COUNTRIES_	[IGOARBBUSAPE]; NGO_Actors
AFRICAN_AMERICAN_ISLAMIC_INSTITUTE_	[NGOWAFMOS] ;MleH 01 Jul 2010
AFRICAN_MEDICAL_AND_RESEARCH_FOUNDATION_	[NGOAFRHLH] ;MleH 01 Jul 2010
AFS_INTERCULTURAL_	[NGOEDU] ;MleH 01 Jul 2010
AL_KHOEI_FOUNDATION_	[NGOMDEMOSSHI] ;MleH 01 Jul 2010
AMERICAN_ASSOCIATION_FOR_THE_ADVANCEMENT_OF_SCIENCE_	[NGOUSAEDU] ;MleH 01 Jul 2010
ASIA_CRIME_PREVENTION_FOUNDATION_	[NGOBGDCOP] ;MleH 01 Jul 2010
ASSOCIATION_FOR_SUSTAINABLE_HUMAN_DEVELOPMENT_	[NGOEEURENV] ;MleH 01 Jul 2010
BILL_AND_MELINDA_GATES_FOUNDATION_	[NGODEVUSA]; NGO_Actors
CATHOLIC_RELIEF_SERVICES_	[NGOUSACHRCTH] ;MleH 01 Jul 2010
COUNCIL_OF_ACADEMIES_OF_ENGINEERING_AND_TECHNOLOGICAL_SCIENCES_	[NGOUSAEDU]; NGO_Actors
COVENANT_HOUSE_	[NGOUSACHRCTH] ;MleH 01 Jul 2010
DESERT_RESEARCH_FOUNDATION_OF_NAMIBIA_	[NGONMRENV]; NGO_Actors
EVANGELICAL_LUTHERAN_CHURCH_IN_AMERICA_DIVISION_FOR_GLOBAL_MISSION_	[NGOUSACHRPRO214]; NGO_Actors	v.0.1.0
EXPERIMENT_IN_INTERNATIONAL_LIVING_	[NGOUSAEDU] ;MleH 01 Jul 2010
FOCUS_ON_THE_GLOBAL_SOUTH_	[NGOASADEV]; NGO_Actors
FRIENDS_OF_THE_UNITED_NATIONS_	[NGOMED]; not sure how to code this, it's not actually under the UNO; NGO_Actors
GLOBAL_EDUCATION_ASSOCIATES_	[NGOEDU]	; NGO_Actors
GLOBAL_HEALTH_COUNCIL_	[NGOHLH] ;MleH 01 Jul 2010
GLOBAL_POLICY_FORUM_	[NGOUSA] ;MleH 01 Jul 2010
HUMAN_RIGHTS_IN_CHINA_(HRIC)	[NGOCHNHRI]; have to add the bracketed definition, otherwise it picks up as many false hits as true; NGO_Actors
HUMAN_RIGHTS_INTERNET HARVARD_	[NGOUSAHRI <900101][NGOCANHRI]; a little bit jerry-rigged, but should work; NGO_Actors
HUMAN_RIGHTS_INTERNET OTTAWA_	[NGOUSAHRI <900101][NGOCANHRI]; a little bit jerry-rigged, but should work; NGO_Actors
HUMANE_SOCIETY_OF_THE_UNITED_STATES_	[NGOUSAENV]; NGO_Actors
INSTITUTO_SOCIAL_Y_POLITICO_DE_LA_MUJER_	[NGOARGHRI] ;MleH 01 Jul 2010
INTERNATIONAL_ASSOCIATION_FOR_RELIGIOUS_FREEDOM_	[NGOGBRRELHRI] ;MleH 01 Jul 2010
INTERNATIONAL_CENTER_FOR_RESEARCH_ON_WOMEN_	[NGOUSADEV] ;MleH 01 Jul 2010
INTERNATIONAL_RESCUE_COMMITTEE_	[NGOUSA] ;MleH 01 Jul 2010
INTERNATIONAL_SOCIETY_FOR_HUMAN_RIGHTS_	[NGODEUHRI] ;MleH 01 Jul 2010
INTERNATIONAL_UYGHUR_YOUTHS_LEAGUE_	[NGOUIG]
INTERNATIONAL_UYGHUR_YOUTH'S_LEAGUE_	[NGOUIG]
INTERNATIONAL_WOMEN'S_TRIBUNE_CENTRE_	[NGO] ;MleH 01 Jul 2010
INTERNS_FOR_PEACE_	[NGOISR]
IRC_INTERNATIONAL_WATER_AND_SANITATION_CENTRE_	[NGOHLHIRCDEV]; improving water sanitation, so both apply; NGO_Actors
LEGAL_ASSISTANCE_CENTRE_NAMIBIA_	[NGONMRHRI]; NGO_Actors
MENNONITE_CENTRAL_COMMITTEE_	[NGONMRCHRPRO] ;MleH 01 Jul 2010
NAMIBIA_DEVELOPMENT_GATEWAY_	[NGONMRDEV]; NGO_Actors
NAMIBIA_INSTITUTE_FOR_DEMOCRACY_	[NGONMRDEV]; NGO_Actors
NAMIBIA_NATURE_FOUNDATION_	[NGONMRENV]; NGO_Actors
NAMIBIAN_ECONOMIC_POLICY_RESEARCH_UNIT_	[NGONMRDEV]; NGO_Actors
PEARL_S._BUCK_FOUNDATION_	[NGOUSAEDU]; supports Asian-American children abroad; NGO_Actors
PROJECT_CONCERN_INTERNATIONAL_	[NGODEV]
SOCIETY_FOR_THE_PSYCHOLOGICAL_STUDY_OF_SOCIAL_ISSUES_	[NGOUSAEDU] ;MleH 01 Jul 2010
TIBETAN_CENTER_FOR_HUMAN_RIGHTS_AND_DEMOCRACY_ 	[NGOCHNTIBHRI] ;MleH 12 Jul 2009; NGO_Actors
UNANIMA_INTERNATIONAL_	[NGOCHRCTHDEV] ;MleH 01 Jul 2010
VIVAT_INTERNATIONAL_	[NGOCHRCTHDEV] ;MleH 01 Jul 2010
WATER_ENVIRONMENT_FEDERATION_	[NGODEV] ;MleH 01 Jul 2010
WOMEN'S_ENVIRONMENT_AND_DEVELOPMENT_ORGANIZATION_	[NGOUSADEV] ;MleH 01 Jul 2010
WOMEN'S_FEDERATION_FOR_WORLD_PEACE_	[NGOCHR] ;MleH 01 Jul 2010	v0.1.0
WOMEN'S_INTERNATIONAL_DEMOCRATIC_FEDERATION_	[NGOLAM] ;MleH 01 Jul 2010
WOMEN'S_INTERNATIONAL_ZIONIST_ORGANIZATION_	[NGOISRJEW] ;MleH 01 Jul 2010
WORLD_SAFETY_ORGANIZATION_	[NGOBUS] ;MleH 01 Jul 2010
WORLDWATCH_INSTITUTE_	[NGOUSAENV] ;MleH 01 Jul 2010
HAMID_AL_GABID_	[MOS]; president of the Organisation of the Islamic Conference; NGO_Actors
KAUSHAL_KISHOR_	[HINRAD]; World Hindu Council; NGO_Actors
MANOHARPURI_	[HINRAD]; World Hindu Council; NGO_Actors
MOROPANT_PINGLE_	[HINRAD]; World Hindu Council; NGO_Actors
N._P._RIJAL_	[HINRAD]; World Hindu Council; NGO_Actors
N.P._RIJAL_	[HINRAD]; World Hindu Council; NGO_Actors
N_P_RIJAL_	[HINRAD]; World Hindu Council; NGO_Actors
NAGENDA_P RIJAL_	[HINRAD]; World Hindu Council; NGO_Actors
NP_RIJAL_	[HINRAD]; World Hindu Council; NGO_Actors
QUAKER_UNITED_NATIONS_OFFICE_	[CHRPRO]; they represent Quakers at the UN, so no actual affiliation?; ReligiousGroups.txt
S._RITAMBHARA_	[HINRAD]; World Hindu Council; NGO_Actors
S_RITAMBHARA_	[HINRAD]; World Hindu Council; NGO_Actors
SADHVI_RITAMBHARA_	[HINRAD]; World Hindu Council; NGO_Actors
SURYA_KRISHNA_	[HINRAD]; World Hindu Council; NGO_Actors
U._S._BHARATI_	[HINRAD]; World Hindu Council; NGO_Actors
U.S._BHARATI_	[HINRAD]; World Hindu Council; NGO_Actors
U_S_BHARATI_	[HINRAD]; World Hindu Council; NGO_Actors
UMA_S BHARATI_	[HINRAD]; World Hindu Council; NGO_Actors
US_BHARATI_	[HINRAD]; World Hindu Council; NGO_Actors
V.H._DALMIYA_	[HINRAD]; World Hindu Council; NGO_Actors
VH_DALMIYA_	[HINRAD]; World Hindu Council; NGO_Actors
VISHNU_DALMIYA_	[HINRAD]; World Hindu Council; NGO_Actors
VISHNU_H DALMIYA_	[HINRAD]; World Hindu Council; NGO_Actors
VISHWA_HINDU_PARISHAD_	[HINRAD]; World Hindu Council; NGO_Actors
VISWA_HINDU_PARISHAD_	[HINRAD]; ReligiousGroups.txt
WORLD_HINDU_ORGANIZATION_	[HINRAD]; ReligiousGroups.txt